�	�
�CI	�CI
�G	�G
�L	�L
�M	�M
�MOL	�MOL
A	A
�	�
�	�
AAAAH	AAAAH
AAAH	AAAH
AAGH	AAGH
AAH	AAH
AARGH	AARGH
AB	AB
ABANDONS	ABANDON
ABASING	ABASE
ABATES	ABATE
ABBE	ABBE
ABBREVIATED	ABBREVIATE
ABCD	ABCD
ABD	ABD
ABDELKADER	ABDELKADER
ABDICATES	ABDICATE
ABDOULAYE	ABDOULAYE
ABDUCTED	ABDUCT
ABETTED	ABET
ABHORS	ABHOR
ABIDES	ABIDE
ABJURED	ABJURE
ABLEST	ABL
ABLATED	ABLATE
ABO	ABO
ABOARD	ABOARD
ABOLISHES	ABOLISH
ABOOT	ABOOT
ABORTS	ABORT
ABOU	ABOU
ABOUNDS	ABOUND
ABOUT	ABOUT
ABOVE	ABOVE
ABRADED	ABRADE
ABRIDGED	ABRIDGE
ABROGATES	ABROGATE
ABS	ABS
ABSCONDS	ABSCOND
ABSEILED	ABSEIL
ABSENTS	ABSENT
ABSENTIA	ABSENTIA
ABSOLVES	ABSOLVE
ABSORBS	ABSORB
ABSTAINED	ABSTAIN
ABSTRACTS	ABSTRACT
ABSURDUM	ABSURDUM
ABTRUST	ABTRUST
ABUBAKAR	ABUBAKAR
ABUDAH	ABUDAH
ABUL	ABUL
ABUSES	ABUSE
ABUTS	ABUT
AC	AC
ACC	ACC
ACCE	ACCE
ACCEDES	ACCEDE
ACCELERATES	ACCELERATE
ACCENTED	ACCENT
ACCENTUATES	ACCENTUATE
ACCEPTS	ACCEPT
ACCESSES	ACCESS
ACCESSORISE	ACCESSORISE
ACCLAIMED	ACCLAIM
ACCLIMATISED	ACCLIMATISE
ACCLIMATIZED	ACCLIMATIZE
ACCOMMODATES	ACCOMMODATE
ACCOMODATE	ACCOMODATE
ACCOMPANIES	ACCOMPANY
ACCOMPLI	ACCOMPLI
ACCOMPLISHES	ACCOMPLISH
ACCORDS	ACCORD
ACCORDING	ACCORDING
ACCOSTS	ACCOST
ACCOUNTS	ACCOUNT
ACCREDITED	ACCREDIT
ACCRETES	ACCRETE
ACCRUES	ACCRUE
ACCUMULATES	ACCUMULATE
ACCUSES	ACCUSE
ACCUSTOMS	ACCUSTOM
ACETYLATED	ACETYLATE
ACHES	ACH
ACHED	ACHE
ACHIEVES	ACHIEVE
ACHIEVER	ACHIEVER
ACHILLEA	ACHILLEA
ACIDIFIED	ACIDIFY
ACKNOWLEDGES	ACKNOWLEDGE
ACQUA	ACQUA
ACQUAINTS	ACQUAINT
ACQUIESCED	ACQUIESCE
ACQUIRES	ACQUIRE
ACQUITTED	ACQUIT
ACROSS	ACROSS
ACTS	ACT
ACTIONS	ACTION
ACTIVATES	ACTIVATE
ACTU	ACTU
ACTUALISED	ACTUALISE
ACTUALIZED	ACTUALIZE
ACTUATES	ACTUATE
ACUTEST	ACUTE
AD	AD
ADAPTS	ADAPT
ADDS	ADD
ADDICTED	ADDICT
ADDLED	ADDLE
ADDRESSES	ADDRESS
ADDUCES	ADDUCE
ADE	ADE
ADEL	ADEL
ADF	ADF
ADHERES	ADHERE
ADIEU	ADIEU
ADIPOSE	ADIPOSE
ADJOINS	ADJOIN
ADJOURNED	ADJOURN
ADJUDGED	ADJUDGE
ADJUDICATED	ADJUDICATE
ADJURED	ADJURE
ADJUSTS	ADJUST
ADMIN	ADMIN
ADMINISTERS	ADMINISTER
ADMINISTRATING	ADMINISTRATE
ADMIRES	ADMIRE
ADMITS	ADMIT
ADMONISHES	ADMONISH
ADOLPHE	ADOLPHE
ADOPTS	ADOPT
ADORES	ADORE
ADORNS	ADORN
ADRENALINE	ADRENALINE
ADSORBED	ADSORB
ADSS	ADSS
ADULTERATED	ADULTERATE
ADUMBRATES	ADUMBRATE
ADV	ADV
ADVANCES	ADVANCE
ADVANTAGED	ADVANTAGE
ADVENTURING	ADVENTURE
ADVERTED	ADVERT
ADVERTISES	ADVERTISE
ADVISES	ADVISE
ADVOCATES	ADVOCATE
ADZING	ADZE
AE	AE
AEG	AEG
AER	AER
AERATED	AERATE
AEROTOWING	AEROTOW
�T	�T
�THELRED	AETHELRED
AETHER	AETHER
AF	AF
AFF	AFF
AFFECTS	AFFECT
AFFIANCED	AFFIANCE
AFFILIATED	AFFILIATE
AFFIRMS	AFFIRM
AFFIXED	AFFIX
AFFLICTS	AFFLICT
AFFORDS	AFFORD
AFFRONTED	AFFRONT
AFHQ	AFHQ
AFORE	AFORE
AFORESAID	AFORESAY
AFRIQUE	AFRIQUE
AFT	AFT
AFTER	AFTER
AG	AG
AGA	AGA
AGAIN	AGAIN
AGAINST	AGAINST
AGES	AGE
AGED	AGED
AGEGATE	AGEGATE
AGEN	AGEN
AGENT	AGENT
AGGLUTINATED	AGGLUTINATE
AGGRAVATES	AGGRAVATE
AGGREGATES	AGGREGATE
AGITATES	AGITATE
AGNUS	AGNUS
AGONISES	AGONISE
AGONIZED	AGONIZE
AGREES	AGREE
AGUNG	AGUNG
AH	AH
AHA	AHA
AHEM	AHEM
AHH	AHH
AHHH	AHHH
AI	AI
AIB	AIB
AIDS	AID
AIDE	AIDE
AILS	AIL
AIMS	AIM
AIN	AIN
AIRS	AIR
AIRBURST	AIRBURST
AIRCONDITIONED	AIRCONDITION
AIRCREW	AIRCREW
AIRDROPS	AIRDROP
AIRLIFTED	AIRLIFT
AIRIER	AIRY
AITHOUGH	AITHOUGH
AKADEMIE	AKADEMIE
AKCE	AKCE
AL	AL
ALA	ALA
ALARMS	ALARM
ALAS	ALAS
ALASDAIR	ALASDAIR
ALBA	ALBA
ALBEIT	ALBEIT
ALBORNE	ALBORNE
ALBRECHT	ALBRECHT
ALDERCINE	ALDERCINE
ALDHELM	ALDHELM
ALDI	ALDI
ALED	ALE
ALEKSANDR	ALEKSANDR
ALERTS	ALERT
ALIA	ALIA
ALIAS	ALIAS
ALICK	ALICK
ALIENATES	ALIENATE
ALIGHTS	ALIGHT
ALIGNS	ALIGN
ALIX	ALIX
ALKYLATE	ALKYLATE
ALL	ALL
ALLA	ALLA
ALLAYS	ALLAY
ALLE	ALLE
ALLEGES	ALLEGE
ALLELUIA	ALLELUIA
ALLER	ALLER
ALLEVIATES	ALLEVIATE
ALLO	ALLO
ALLOCATES	ALLOCATE
ALLOTS	ALLOT
ALLOWS	ALLOW
ALLOYED	ALLOY
ALLUDES	ALLUDE
ALLURE	ALLURE
ALLIES	ALLY
ALMA	ALMA
ALONG	ALONG
ALONGSIDE	ALONGSIDE
ALORS	ALORS
ALPHA	ALPHA
ALR	ALR
ALS	ALS
ALT	ALT
ALTERS	ALTER
ALTERNATES	ALTERNATE
ALTHOUGH	ALTHOUGH
ALUN	ALUN
AM	AM
AMALGAMATED	AMALGAMATE
AMARU	AMARU
AMASSED	AMASS
AMAZES	AMAZE
AMBLES	AMBLE
AMBUSHED	AMBUSH
AMELIORATES	AMELIORATE
AMEN	AMEN
AMENDS	AMEND
AMER	AMER
AMERCED	AMERCE
AMI	AMI
AMID	AMID
AMIDST	AMIDST
AMIGO	AMIGO
AMNESTIED	AMNESTY
AMO	AMO
AMONG	AMONG
AMONGST	AMONGST
AMOR	AMOR
AMORTISED	AMORTISE
AMORTIZED	AMORTIZE
AMOUNTS	AMOUNT
AMPHETAMINES	AMPHETAMINE
AMPLIFIES	AMPLIFY
AMPUTATES	AMPUTATE
AMUSES	AMUSE
AN	AN
ANA	ANA
ANAESTHETISED	ANAESTHETISE
ANAESTHETIZED	ANAESTHETIZE
ANAL	ANAL
ANALYSES	ANALYSE
ANALYZES	ANALYZE
ANCHORS	ANCHOR
ANCHORED	ANCHORE
ANCIEN	ANCIEN
ANDS	AND
ANDF	ANDF
ANDREW	ANDREW
ANG	ANG
�NGEL	�NGEL
ANGERS	ANGER
ANGLAIS	ANGLAIS
ANGLAISE	ANGLAISE
ANGLED	ANGLE
ANGLICISE	ANGLICISE
ANGLICIZED	ANGLICIZE
ANGOLA	ANGOLA
ANGRIEST	ANGRY
ANGUISHING	ANGUISH
ANIL	ANIL
ANIMATES	ANIMATE
ANNABEL	ANNABEL
ANNALES	ANNALES
ANNEALING	ANNEAL
ANNEXES	ANNEX
ANNIHILATES	ANNIHILATE
ANNO	ANNO
ANNOTATED	ANNOTATE
ANNOUNCES	ANNOUNCE
ANNOYS	ANNOY
ANNULLED	ANNUL
ANNUM	ANNUM
ANNUS	ANNUS
ANO	ANO
ANOINTS	ANOINT
ANOTHERS	ANOTHER
ANS	ANS
ANSELM	ANSELM
ANSWERS	ANSWER
ANT	ANT
ANTAGONISES	ANTAGONISE
ANTAGONIZED	ANTAGONIZE
ANTE	ANTE
ANTEDATES	ANTEDATE
ANTI	ANTI
ANTICIPATES	ANTICIPATE
ANTINEUTROPHIL	ANTINEUTROPHIL
ANTIQUAIRES	ANTIQUAIRES
ANTIQUED	ANTIQUE
ANTIRRHINUM	ANTIRRHINUM
ANTOINE	ANTOINE
ANWAR	ANWAR
ANY	ANY
ANYBODY	ANYBODY
ANYONE	ANYONE
ANYTHING	ANYTHING
AONACH	AONACH
APED	AP
APACKED	APACK
APART	APART
APARTADO	APARTADO
APC	APC
APES	APE
APO	APO
APOLOGISES	APOLOGISE
APOLOGIZES	APOLOGIZE
APONOGETON	APONOGETON
APPS	APP
APPALS	APPAL
APPARENT	APPARENT
APPEALS	APPEAL
APPEARS	APPEAR
APPEASED	APPEASE
APPEL	APPEL
APPENED	APPEN
APPENDS	APPEND
APPENDIX	APPENDIX
APPERTAINS	APPERTAIN
APPETISING	APPETISE
APPETIT	APPETIT
APPLAUDS	APPLAUD
APPLIQU�D	APPLIQU�D
APPLIX	APPLIX
APPLIES	APPLY
APPOINTS	APPOINT
APPORTIONS	APPORTION
APPRAISES	APPRAISE
APPRECIATES	APPRECIATE
APPREHENDS	APPREHEND
APPRENTICED	APPRENTICE
APPRISED	APPRISE
APPRO	APPRO
APPROACHES	APPROACH
APPROPRIATES	APPROPRIATE
APPROVES	APPROVE
APPROXIMATES	APPROXIMATE
APRES	APRES
APR�S	APR�S
APROPOS	APROPOS
APTER	APT
AQUA	AQUA
AQUASCAPING	AQUASCAPE
AR	AR
ARBALEST	ARBALE
ARBITRAGING	ARBITRAGE
ARBITRATES	ARBITRATE
ARBUCKLE	ARBUCKLE
ARC	ARC
ARCADING	ARCADE
ARCING	ARCE
ARCHES	ARCH
ARCHBOLD	ARCHBOLD
ARCHIVED	ARCHIVE
ARE	ARE
ARF	ARF
ARGHATUN	ARGHATUN
ARGOL	ARGOL
ARGUES	ARGUE
ARI	ARI
ARIANE	ARIANE
ARISES	ARISE
ARJUN	ARJUN
ARKLE	ARKLE
ARMS	ARM
ARMAND	ARMAND
ARMREST	ARMR
ARNDORFER	ARNDORFER
ARNULF	ARNULF
AROUND	AROUND
AROUSES	AROUSE
ARR	ARR
ARRAIGNED	ARRAIGN
ARRANGES	ARRANGE
ARRAYED	ARRAY
ARRESTS	ARREST
ARRIVES	ARRIVE
ARROGATES	ARROGATE
ARROWING	ARROW
ARSED	ARSE
ART	ART
ARTE	ARTE
ARTEX	ARTEX
ARTHIT	ARTHIT
ARTICLED	ARTICLE
ARTICULATES	ARTICULATE
ARTS	ARTS
ARTUR	ARTUR
AS	AS
ASAP	ASAP
ASCENDS	ASCEND
ASCERTAINS	ASCERTAIN
ASCRIBES	ASCRIBE
ASHOK	ASHOK
ASKS	ASK
ASKE	ASKE
ASL	ASL
ASPHYXIATED	ASPHYXIATE
ASPIRATED	ASPIRATE
ASPIRES	ASPIRE
ASS	ASS
ASSAILS	ASSAIL
ASSASSINATED	ASSASSINATE
ASSAULTS	ASSAULT
ASSAYED	ASSAY
ASSEMBLES	ASSEMBLE
ASSENTS	ASSENT
ASSERTS	ASSERT
ASSESSES	ASSESS
ASSHE	ASSHE
ASSIGNS	ASSIGN
ASSIMILATES	ASSIMILATE
ASSISTS	ASSIST
ASSOCIATES	ASSOCIATE
ASSUAGES	ASSUAGE
ASSUMES	ASSUME
ASSURES	ASSURE
AST	AST
ASTERIX	ASTERIX
ASTI	ASTI
ASTONISHES	ASTONISH
ASTOUNDS	ASTOUND
ASTRIDE	ASTRIDE
ASTROLOGER	ASTROLOGER
ASWS	ASW
ASWELL	ASWELL
AT	AT
ATB	ATB
ATENOLOL	ATENOLOL
ATHWART	ATHWART
ATOLLS	ATOLL
ATONED	ATON
ATONE	ATONE
ATOP	ATOP
ATROPHIED	ATROPHY
ATT	ATT
ATTACHES	ATTACH
ATTACH�S	ATTACH�S
ATTACKS	ATTACK
ATTAINS	ATTAIN
ATTEMPTS	ATTEMPT
ATTENDS	ATTEND
ATTENUATES	ATTENUATE
ATTESTS	ATTEST
ATTIRED	ATTIRE
ATTRACTS	ATTRACT
ATTRIBUTES	ATTRIBUTE
ATTUNED	ATTUNE
AU	AU
AUCTIONS	AUCTION
AUCTIONEERING	AUCTIONEER
AUDITS	AUDIT
AUDITIONS	AUDITION
AUF	AUF
AUG	AUG
AUGHT	AUGHT
AUGMENTS	AUGMENT
AUGURS	AUGUR
AUGURED	AUGURE
AULD	AULD
AUNG	AUNG
AUREA	AUREA
AURORA	AURORA
AUS	AUS
AUSSI	AUSSI
AUT	AUT
AUTHENTICATED	AUTHENTICATE
AUTHORED	AUTHORE
AUTHORISES	AUTHORISE
AUTHORIZES	AUTHORIZE
AUTOCATALYST	AUTOCATALYST
AUTOCLAVED	AUTOCLAVE
AUTODESK	AUTODESK
AUTOGRAPHED	AUTOGRAPH
AUTOMATES	AUTOMATE
AUTORADIOGRAPHED	AUTORADIOGRAPH
AUTRE	AUTRE
AUTREFOIS	AUTREFOIS
AUTRES	AUTRES
AUX	AUX
AV	AV
AVA	AVA
AVAILS	AVAIL
AVALANCHES	AVALANCH
AVANT	AVANT
AVE	AVE
AVEC	AVEC
AVENGING	AVENG
AVENGES	AVENGE
AVERS	AVER
AVERAGES	AVERAGE
AVERTS	AVERT
AVIZE	AVIZE
AVOIDS	AVOID
AVOWS	AVOW
AVRIL	AVRIL
AW	AW
AWA	AWA
AWAITS	AWAIT
AWAKES	AWAKE
AWAKENS	AWAKEN
AWARDS	AWARD
AWED	AWE
AWESTRUCK	AWESTRUCK
AXING	AX
AXED	AXE
AXL	AXL
AY	AY
A�	A�
AYE	AYE
AYLING	AYLE
AZHAG	AZHAG
AZIZ	AZIZ
AZMAVETH	AZMAVETH
B	B
BA	BA
BAA	BAA
BABBLE	BABBLE
BABUR	BABUR
BABY	BABY
BABYSIT	BABYSIT
BACCHUS	BACCHUS
BACKS	BACK
BACKBENCH	BACKBENCH
BACKBITING	BACKBIT
BACKCOMBED	BACKCOMB
BACKDATED	BACKDATE
BACKFILL	BACKFILL
BACKFIRES	BACKFIRE
BACKHANDED	BACKHAND
BACKHANDERS	BACKHANDER
BACKPACKING	BACKPACK
BACKPEDALLING	BACKPEDAL
BACKREF	BACKREF
BACKSLIDE	BACKSLIDE
BACKSTITCH	BACKSTITCH
BACKTRACKS	BACKTRACK
BACKUP	BACKUP
BACKWARDS	BACKWARDS
BACKWASHING	BACKWASH
WORST	BAD
BADGING	BADGE
BADGERS	BADGER
BAFFLES	BAFFLE
BAGGED	BAG
BAH	BAH
BAILED	BAIL
BAIN	BAIN
BAITS	BAIT
BAJA	BAJA
BAKES	BAKE
BAL	BAL
BALANCES	BALANCE
BALDEST	BALD
BALED	BALE
BALKED	BALK
BALL	BALL
BALLASTED	BALLAST
BALLET	BALLET
BALLO	BALLO
BALLOONED	BALLOON
BALLOT	BALLOT
BALLOTED	BALLOTE
BALUSTRADING	BALUSTRADE
BAMBINO	BAMBINO
BAMBOOZLED	BAMBOOZLE
BANS	BAN
BANA	BANA
BANDS	BAND
BANDAGED	BANDAGE
BANDITS	BANDIT
BANDIED	BANDY
BANGS	BANG
BANISHES	BANISH
BANKS	BANK
BANKROLLED	BANKROL
BANKROLL	BANKROLL
BANKRUPTS	BANKRUPT
BANQUE	BANQUE
BANQUETING	BANQUETE
BANTAM	BANTAM
BANTERED	BANTER
BAPTISED	BAPTISE
BAPTIZES	BAPTIZE
BARS	BAR
BARAT	BARAT
BARBECUES	BARBECUE
BARBEL	BARBEL
BARDING	BARD
BARDUL	BARDUL
BARES	BARE
BARGAINS	BARGAIN
BARGES	BARGE
BARKS	BARK
BARNACLED	BARNACLE
BARRACKED	BARRACK
BARRELLING	BARREL
BARRICADED	BARRICADE
BARRING	BARRING
BARRIO	BARRIO
BARRIOS	BARRIOS
BARTERED	BARTER
BARUCH	BARUCH
BAS	BAS
BASES	BASE
BASHES	BASH
BASINS	BASIN
BASKS	BASK
BASQUE	BASQUE
BASSO	BASSO
BASTA	BASTA
BASTED	BASTE
BASW	BASW
BATS	BAT
BATASUNA	BATASUNA
BATCH	BATCH
BATE	BATE
BATHS	BATH
BATHES	BATHE
BATTENED	BATTEN
BATTERS	BATTER
BATTEUR	BATTEUR
BATTLED	BATTLE
BAULKED	BAULK
BAWLS	BAWL
BAYS	BAY
BAYES	BAYE
BAYERN	BAYERN
BAZ	BAZ
IS	BE
BEACHED	BEACH
BEADED	BEAD
BEAMS	BEAM
BEAMISH	BEAMISH
BEARS	BEAR
BEARDING	BEARD
BEARETH	BEARETH
BEARING	BEARING
BEATS	BEAT
BEAU	BEAU
BEAUCOUP	BEAUCOUP
BEAUTIFY	BEAUTIFY
BEAVERS	BEAVER
BEC	BEC
BECA	BECA
BECAU	BECAU
BECAUSE	BECAUSE
BECKONS	BECKON
BECO	BECO
BECOMES	BECOME
BEDS	BED
BEDECKED	BEDECK
BEDEVILS	BEDEVIL
BEDEVILED	BEDEVILE
BEDWETTING	BEDWET
BEEFED	BEEF
BEEFIER	BEEFY
BEEP	BEEP
BEETLED	BEETLE
BEF	BEF
BEFALLS	BEFALL
BEFITS	BEFIT
BEFORE	BEFORE
BEFRIENDS	BEFRIEND
BEGS	BEG
BEGAT	BEGAT
BEGETS	BEGET
BEGGARS	BEGGAR
BEGINS	BEGIN
BEGOTTEN	BEGOTTEN
BEGRUDGES	BEGRUDGE
BEGUILED	BEGUILE
BEHAVES	BEHAVE
BEHEADED	BEHEAD
BEHELD	BEHELD
BEHIND	BEHIND
BEHOLDS	BEHOLD
BEHOVES	BEHOVE
BEI	BEI
BEL	BEL
BELABOUR	BELABOUR
BELAY	BELAY
BELCHES	BELCH
BELEIVES	BELEIVE
BELGICA	BELGICA
BELIES	BELIE
BELIEVES	BELIEVE
BELITTLES	BELITTLE
BELLING	BELL
BELLA	BELLA
BELLE	BELLE
BELLIS	BELLI
BELLISSIMA	BELLISSIMA
BELLOWS	BELLOW
BELLUM	BELLUM
BELLYING	BELLY
BELONGS	BELONG
BELOW	BELOW
BELTS	BELT
BELIED	BELY
BEM	BEM
BEMOANS	BEMOAN
BEMUSE	BEMUSE
BEN	BEN
BENCHED	BENCH
BENCHMARKING	BENCHMARK
BENDS	BEND
BENDA	BENDA
BENE	BENE
BENEATH	BENEATH
BENEFICED	BENEFICE
BENEFITS	BENEFIT
BENELUX	BENELUX
BENI	BENI
BENSTEDE	BENSTEDE
BEQUEATHS	BEQUEATH
BEQUEATHING	BEQUETHE
BER	BER
BERATES	BERATE
BERBERIS	BERBERIS
BEREAVED	BEREAVE
BERGHAUS	BERGHAUS
BERTHED	BERTH
BESEECH	BESEECH
BESETS	BESET
BESIDE	BESIDE
BESIDES	BESIDES
BESIEGED	BESIEGE
BESMIRCHED	BESMIRCH
BESOTTED	BESOT
BESPEAKS	BESPEAK
BESPOKE	BESPOKE
BESTS	BEST
BESTIR	BESTIR
BESTOWS	BESTOW
BESTRODE	BESTRODE
BETS	BET
B�TE	B�TE
BETIDE	BETIDE
BETNOVATE	BETNOVATE
BETOKENS	BETOKEN
BETRAYS	BETRAY
BETROTHED	BETROTH
BETTERS	BETTER
BETWEEN	BETWEEN
BETWIXT	BETWIXT
BEVELLED	BEVEL
BEWAIL	BEWAIL
BEWARE	BEWARE
BEWILDERS	BEWILDER
BEWITCHED	BEWITCH
BEYOND	BEYOND
BI	BI
BIANCO	BIANCO
BIASED	BIAS
BIASES	BIASE
BIB	BIB
BICKERS	BICKER
BICYCLE	BICYCLE
BIDS	BID
BIDES	BIDE
BIEN	BIEN
BIENNALE	BIENNALE
BIFF	BIFF
BIFIDA	BIFIDA
BIFURCATES	BIFURCATE
BIG	BIG
BIGWIG	BIGWIG
BIKE	BIKE
BIL	BIL
BILLS	BILL
BILLET	BILLET
BILLETED	BILLETE
BILLIG	BILLIG
BILLION	BILLION
BILLIONS	BILLIONS
BILLOWS	BILLOW
BINNED	BIN
BINDS	BIND
BINGE	BINGE
BIOPSIED	BIOPSY
BIOTINYLATED	BIOTINYLATE
BIRCHED	BIRCH
BIRDWATCHING	BIRDWATCH
BIRDIED	BIRDY
BIRKS	BIRK
BIS	BIS
BISECTS	BISECT
BIT	BIT
BITCHES	BITCH
BITES	BITE
BITEZ	BITEZ
BITTEN	BITTEN
BITTEREST	BITTERE
BIVOUAC	BIVOUAC
BIVOUACKED	BIVOUACK
BL	BL
BLA	BLA
BLAB	BLAB
BLACKED	BLACK
BLACKBALLED	BLACKBAL
BLACKBERRYING	BLACKBERRY
BLACKENS	BLACKEN
BLACKLISTED	BLACKLIST
BLACKMAILED	BLACKMAIL
BLAG	BLAG
BLAGG	BLAGG
BLAH	BLAH
BLAISE	BLAISE
BLAMES	BLAME
BLANC	BLANC
BLANCHES	BLANCH
BLANCHE	BLANCHE
BLANDER	BLAND
BLANKED	BLANK
BLANKETED	BLANKET
BLANKETING	BLANKETE
BLARE	BLARE
BLASPHEMED	BLASPHEME
BLASTS	BLAST
BLATHERING	BLATHER
BLAZES	BLAZE
BLAZONED	BLAZON
BLEACHES	BLEACH
BLEAKEST	BLEAK
BLEATS	BLEAT
BLEEDS	BLEED
BLEEPS	BLEEP
BLEMISHED	BLEMISH
BLENCHED	BLENCH
BLENDS	BLEND
BLESSES	BLESS
BLEU	BLEU
BLIGHTS	BLIGHT
BLIMEY	BLIMEY
BLINDS	BLIND
BLINDFOLDED	BLINDFOLD
BLINKS	BLINK
BLINKERED	BLINKER
BLISTERED	BLISTER
BLITZ	BLITZ
BLITZED	BLITZE
BLO	BLO
BLOATING	BLOAT
BLOC	BLOC
BLOCKS	BLOCK
BLOCKADED	BLOCKADE
BLOK	BLOK
BLONDER	BLOND
BLOODED	BLOOD
BLOODIED	BLOODY
BLOOMS	BLOOM
BLOSSOMS	BLOSSOM
BLOSSOMING	BLOSSOME
BLOTS	BLOT
BLOTCHED	BLOTCH
BLOWS	BLOW
BLU	BLU
BLUBBING	BLUB
BLUBBERING	BLUBBER
BLUDGEONED	BLUDGEON
BLUE	BLUE
BLUEJOHN	BLUEJOHN
BLUFFED	BLUFF
BLUNDERS	BLUNDER
BLUNTS	BLUNT
BLURS	BLUR
BLURGH	BLURGH
BLURTS	BLURT
BLUSHES	BLUSH
BLUSTER	BLUSTER
BO	BO
BOARDS	BOARD
BOASTS	BOAST
BOATING	BOAT
BOBS	BOB
BOBBLING	BOBBLE
BOCKING	BOCK
BODES	BODE
BODGED	BODGE
BODIED	BODY
BOEUF	BOEUF
BOGGED	BOG
BOGEYING	BOGEY
BOGGLES	BOGGLE
BOGTROTTER	BOGTROTTER
BOH�ME	BOH�ME
BOHUNT	BOHUNT
BOILS	BOIL
BOIS	BOIS
BOLDEST	BOLD
BOLOGNESE	BOLOGNESE
BOLSTERS	BOLSTER
BOLTS	BOLT
BOM	BOM
BOMBS	BOMB
BOMBARDED	BOMBARD
BONED	BON
BONA	BONA
BONAVENTURE	BONAVENTURE
BONDS	BOND
BONE	BONE
BONHEUR	BONHEUR
BONJOUR	BONJOUR
BONK	BONK
BONNE	BONNE
BONNIEST	BONNY
BOOS	BOO
BOOBED	BOOB
BOOED	BOOE
BOOGIE	BOOGIE
BOOKS	BOOK
BOOKISH	BOOKISH
BOOKSELLING	BOOKSEL
BOOKWORMS	BOOKWORM
BOOMED	BOOM
BOOMERANG	BOOMERANG
BOOSTS	BOOST
BOOTS	BOOT
BOOTLEGGED	BOOTLEG
BOOZE	BOOZE
BOP	BOP
BOR	BOR
BORDERED	BORDER
BORDIGHERA	BORDIGHERA
BORES	BORE
BOREALIS	BOREALIS
BORROWS	BORROW
BOSSES	BOSS
BOT	BOT
BOTCHED	BOTCH
BOTH	BOTH
BOTHERS	BOTHER
BOTTLES	BOTTLE
BOTTOM	BOTTOM
BOTTOMED	BOTTOME
BOU	BOU
BOUNCES	BOUNCE
BOUNCIER	BOUNCY
BOUNDS	BOUND
BOURGEOIS	BOURGEOIS
BOURR�E	BOURR�E
BOUT	BOUT
BOUTEILLE	BOUTEILLE
BOUTIQUE	BOUTIQUE
BOWS	BOW
BOWLS	BOWL
BOWYER	BOWY
BOXES	BOX
BOYCOTTS	BOYCOTT
BOZ	BOZ
BR	BR
BRA	BRA
BRACES	BRACE
BRACKETS	BRACKET
BRACKETING	BRACKETE
BRAG	BRAG
BRAIDED	BRAID
BRAIN	BRAIN
BRAINWASHED	BRAINWASH
BRAINIEST	BRAINY
BRAISING	BRAISE
BRAKES	BRAKE
BRAMBLING	BRAMBLE
BRANCHES	BRANCH
BRANDS	BRAND
BRANDISHES	BRANDISH
BRANDRETH	BRANDRETH
BRAS	BRAS
BRASHER	BRASH
BRASSED	BRASS
BRAVES	BRAVE
BRAVO	BRAVO
BRAWLING	BRAWL
BRAWNIER	BRAWNY
BRAY	BRAY
BRAZENED	BRAZEN
BRE	BRE
BREACHES	BREACH
BREAKS	BREAK
BREAKFASTED	BREAKFAST
BREAKSPEAR	BREAKSPEAR
BREASTED	BREAST
BREASTFED	BREASTF
BREASTFEED	BREASTFEED
BREATH	BREATH
BREATHALYSED	BREATHALYSE
BREATHES	BREATHE
BREECHES	BREECH
BREEDS	BREED
BREEZED	BREEZE
BREUER	BREUER
BREWS	BREW
BRI	BRI
BRIBES	BRIBE
BRICKED	BRICK
BRIDGES	BRIDGE
BRIDGEWATER	BRIDGEWATE
BRIDLES	BRIDLE
BRIEFS	BRIEF
BRIGHTEST	BRIGHT
BRIGHTENS	BRIGHTEN
BRIMS	BRIM
BRIND	BRIND
BRINDLED	BRINDLE
BRINGS	BRING
BRIO	BRIO
BRISKER	BRISK
BRISTLES	BRISTLE
BRITANNICA	BRITANNICA
BRO	BRO
BROACHES	BROACH
BROADEST	BROAD
BROADCASTS	BROADCAST
BROADENS	BROADEN
BROADLEAVED	BROADLEAVE
BROADWATER	BROADWATE
BROILED	BROIL
BROKERED	BROKER
BROODS	BROOD
BROOKS	BROOK
BROWBEAT	BROWBEAT
BROWBEATEN	BROWBEATEN
BROWNS	BROWN
BROWSES	BROWSE
BRR	BRR
BRRR	BRRR
BRU	BRU
BRUISED	BRUISE
BRUNG	BRUNG
BRURGH	BRURGH
BRUSHES	BRUSH
BRUT	BRUT
BRUTALISED	BRUTALISE
BRUTALIZED	BRUTALIZE
BSP	BSP
BATHING	BTHE
BU	BU
BUB	BUB
BUBBLES	BUBBLE
BUBYE	BUBYE
BUCKED	BUCK
BUCKETING	BUCKETE
BUCKLES	BUCKLE
BUDDED	BUD
BUDGED	BUDGE
BUDGETED	BUDGET
BUDGETING	BUDGETE
BUEN	BUEN
BUENO	BUENO
BUENOS	BUENOS
BUFFS	BUFF
BUFFA	BUFFA
BUFFERED	BUFFER
BUFFETED	BUFFETE
BUGS	BUG
BUGGERS	BUGGER
BUI	BUI
BUILDS	BUILD
BULGES	BULGE
BULK	BULK
BULKIER	BULKY
BULLING	BULL
BULLDOZED	BULLDOZE
BULLFIGHTING	BULLFIGHT
BULLSHITTING	BULLSHIT
BULLIES	BULLY
BUM	BUM
BUMBLES	BUMBLE
BUMPS	BUMP
BUMPIER	BUMPY
BUNCHED	BUNCH
BUNDLES	BUNDLE
BUNGS	BUNG
BUNGLED	BUNGLE
BUNKED	BUNK
BUNKERED	BUNKER
BUOYED	BUOY
BUR	BUR
BURBLES	BURBLE
BURDENED	BURDEN
BUREAU	BUREAU
BUREAUCRATIZED	BUREAUCRATIZE
BURGEONED	BURGEON
B�RGERTUM	B�RGERTUM
BURGLED	BURGLE
BURLIER	BURLY
BURMAH	BURMAH
BURNS	BURN
BURNISHED	BURNISH
BURP	BURP
BURROWS	BURROW
BURSTS	BURST
BURUN	BURUN
BURIES	BURY
BUS	BUS
BUSED	BUSE
BUSHED	BUSH
BUSHIER	BUSHY
BUSK	BUSK
BUSSED	BUSS
BUSTS	BUST
BUSTLES	BUSTLE
BUSTIER	BUSTY
BUSIES	BUSY
BUTTED	BUT
BUTCHERS	BUTCHER
BUTTS	BUTT
BUTTERED	BUTTER
BUTTONS	BUTTON
BUTTONHOLED	BUTTONHOLE
BUTTRESSES	BUTTRESS
BUXTEHUDE	BUXTEHUDE
BUYS	BUY
BUZZED	BUZ
BUZZES	BUZZ
BY	BY
BYE	BYE
BYPASSES	BYPASS
BZZ	BZZ
C	C
CA	CA
�A	�A
CABLED	CABLE
CACHED	CACH
CACHE	CACHE
CACKLES	CACKLE
CADDIES	CADDY
CADGE	CADGE
CAERULEA	CAERULEA
CAF�	CAF�
CAFOD	CAFOD
CAGED	CAGE
CAJOLED	CAJOLE
CAKED	CAKE
CAL	CAL
CALC	CALC
CALCIFYING	CALCIFY
CALCULATES	CALCULATE
CALIBRATED	CALIBRATE
CALLS	CALL
CALLA	CALLA
CALMS	CALM
CALVED	CALVE
CAM	CAM
CAMERA	CAMERA
CAMOUFLAGES	CAMOUFLAGE
CAMPS	CAMP
CAMPAIGNS	CAMPAIGN
CANS	CAN
CANALIZED	CANALIZE
CANCELS	CANCEL
CANED	CANE
CANNA	CANNA
CANNIBALISED	CANNIBALISE
CANNIBALIZE	CANNIBALIZE
CANNONS	CANNON
CANNY	CANNY
CANOE	CANOE
CANONISES	CANONISE
CANONIZED	CANONIZE
CANOPIED	CANOPY
CANST	CANST
CANTED	CANT
CANTERED	CANTER
CANTILEVERED	CANTILEVER
CANTO	CANTO
CANVASSED	CANVAS
CANVASSES	CANVASS
CANZONE	CANZONE
CANZONI	CANZONI
CAPS	CAP
CAPARISONED	CAPARISON
CAPENHURST	CAPENHURST
CAPERING	CAPER
CAPITA	CAPITA
CAPITALISES	CAPITALISE
CAPITALIZES	CAPITALIZE
CAPITULATES	CAPITULATE
CAPPELLA	CAPPELLA
CAPSIZES	CAPSIZE
CAPTAINS	CAPTAIN
CAPTIONED	CAPTION
CAPTIVATES	CAPTIVATE
CAPTURES	CAPTURE
CAR	CAR
CARA	CARA
CARAMEL	CARAMEL
CARAVANNING	CARAVAN
CARBONATED	CARBONATE
CARDED	CARD
CARES	CARE
CAREENING	CAREEN
CAREER	CAREER
CARESSES	CARESS
CAREX	CAREX
CARICATURED	CARICATURE
CARICOM	CARICOM
CARMINA	CARMINA
CARN	CARN
CARO	CARO
CAROL	CAROL
CAROUSE	CAROUSE
CARP	CARP
CARPE	CARPE
CARPETED	CARPET
CARPETING	CARPETE
CARRIES	CARRY
CARTED	CART
CARTA	CARTA
CARTE	CARTE
CARTWHEELING	CARTWHEEL
CARVES	CARVE
CAS	CAS
CASA	CASA
CASCADED	CASCADE
CASES	CASE
CASHES	CASH
CASHIERED	CASHIER
CASPAR	CASPAR
CASS	CASS
CASTS	CAST
CASTEL	CASTEL
CASTIGATES	CASTIGATE
CASTRATES	CASTRATE
CASTROL	CASTROL
CASUS	CASUS
CATALOGUED	CATALOGUE
CATALYSES	CATALYSE
CATAPULTED	CATAPULT
CATCHES	CATCH
CATCHPHRASE	CATCHPHRASE
CATEGORISES	CATEGORISE
CATEGORIZES	CATEGORIZE
CATERS	CATER
CATH	CATH
CATHETER	CATHETE
CAUSA	CAUSA
CAUSES	CAUSE
CAUTERISED	CAUTERISE
CAUTERIZED	CAUTERIZE
CAUTIONS	CAUTION
CAVED	CAVE
CAVIL	CAVIL
CAVORTED	CAVORT
CAWING	CAW
CB	CB
CCI	CCI
CCL	CCL
CDI	CDI
CDL	CDL
CES	CE
CEASES	CEASE
CECIL	CECIL
CEDED	CEDE
CEFN	CEFN
CELEBRATES	CELEBRATE
C�L�BRE	C�L�BRE
CELLULOSE	CELLULOSE
CEMENTS	CEMENT
CEN	CEN
CENSORS	CENSOR
CENSORING	CENSORE
CENSURES	CENSURE
CENT	CENT
CENTERED	CENTER
CENTIGRADE	CENTIGRADE
CENTIPEDE	CENTIPEDE
CENTRAL	CENTRAL
CENTRALE	CENTRALE
CENTRALISED	CENTRALISE
CENTRALIZED	CENTRALIZE
CENTRES	CENTRE
CENTRIFUGED	CENTRIFUGE
CEPT	CEPT
CER	CER
CERT	CERT
CERTIFICATED	CERTIFICATE
CERTIFIES	CERTIFY
CETERA	CETERA
CETERIS	CETERIS
CETTE	CETTE
CFS	CF
CH	CH
CHA	CHA
CHAFED	CHAFE
CHAFFING	CHAFF
CHAIM	CHAIM
CHAINED	CHAIN
CHAIRS	CHAIR
CHAISE	CHAISE
CHAKRA	CHAKRA
CHALKED	CHALK
CHALLENGES	CHALLENGE
CHAMBRE	CHAMBRE
CHAMFERING	CHAMFER
CHAMPING	CHAMP
CHAMPIONS	CHAMPION
CHAMPS	CHAMPS
CHANNING	CHAN
CHANCED	CHANCE
CHANDON	CHANDON
CHANEL	CHANEL
CHANG	CHANG
CHANGES	CHANGE
CHANGEZ	CHANGEZ
CHANNELS	CHANNEL
CHANSONS	CHANSONS
CHANTS	CHANT
CHAPPING	CHAP
CHAPERONED	CHAPERON
CHAPERONE	CHAPERONE
CHARRED	CHAR
CHARACTERISES	CHARACTERISE
CHARACTERIZES	CHARACTERIZE
CHARDONNAY	CHARDONNAY
CHARGES	CHARGE
CHARLES	CHARLES
CHARMED	CHARM
CHARTS	CHART
CHARTERED	CHARTER
CHARVEL	CHARVEL
CHASES	CHASE
CHASTENED	CHASTEN
CHASTISES	CHASTISE
CHATS	CHAT
CHATTERS	CHATTER
CHAUFFEURED	CHAUFFEUR
CHAY	CHAY
CHE	CHE
CHEAPEST	CHEAP
CHEAPENS	CHEAPEN
CHEATS	CHEAT
CHECKS	CHECK
CHEE	CHEE
CHEEKING	CHEEK
CHEEKIEST	CHEEKY
CHEEPING	CHEEP
CHEERED	CHEER
CHEERIO	CHEERIO
CHEERS	CHEERS
CHEERIEST	CHEERY
CHEESED	CHEESE
CHEF	CHEF
CHEN	CHEN
CHEQUERED	CHEQUER
CHERISHES	CHERISH
CHESTED	CHEST
CHEVALIER	CHEVALIER
CHEWS	CHEW
CHEZ	CHEZ
CHI	CHI
CHICKS	CHICK
CHICKENED	CHICKEN
CHIDES	CHIDE
CHIEFEST	CHIEF
CHILDMINDING	CHILDMIND
CHILDREARING	CHILDREAR
CHILE	CHILE
CHILLS	CHILL
CHILLIER	CHILLY
CHIMES	CHIME
CHIMPS	CHIMP
CHINNED	CHIN
CHINE	CHINE
CHIPS	CHIP
CHIRPS	CHIRP
CHIRRUPING	CHIRRUPE
CHISELLED	CHISEL
CHIVVIED	CHIVVY
CHLORINATED	CHLORINATE
CHLOTHAR	CHLOTHAR
CHO	CHO
CHOCKED	CHOCK
CHOICEST	CHOIC
CHOKES	CHOKE
CHOMPS	CHOMP
CHOOSES	CHOOSE
CHOPS	CHOP
CHOPPIER	CHOPPY
CHOREOGRAPHED	CHOREOGRAPH
CHOROPLETH	CHOROPLETH
CHORTLES	CHORTLE
CHORUSED	CHORUS
CHOSE	CHOSE
CHOU	CHOU
CHOUX	CHOUX
CHOW	CHOW
CHR	CHR
CHRIS	CHRIS
CHRIST	CHRIST
CHRISTENED	CHRISTEN
CHRISTI	CHRISTI
CHRISTIAN	CHRISTIAN
CHRISTIANISED	CHRISTIANISE
CHROMATOGRAPHED	CHROMATOGRAPH
CHRONICLES	CHRONICLE
CHU	CHU
CHUCKS	CHUCK
CHUCKLES	CHUCKLE
CHUFFING	CHUFF
CHUGS	CHUG
CHUNG	CHUNG
CHUNKIER	CHUNKY
CHUNTERING	CHUNTER
CHURRED	CHUR
CHURCHED	CHURCH
CHURCHGOING	CHURCHGO
CHURNS	CHURN
CHURT	CHURT
CHUZZLEWIT	CHUZZLEWIT
CI	CI
CIAO	CIAO
CIEL	CIEL
CIGS	CIG
CIL	CIL
CINCHED	CINCH
CINCOM	CINCOM
CINE	CINE
CINERARIA	CINERARIA
CINEREA	CINEREA
CINQ	CINQ
CIOB	CIOB
CIR	CIR
CIRC	CIRC
CIRCLES	CIRCLE
CIRCUITED	CIRCUIT
CIRCULATES	CIRCULATE
CIRCUMCISED	CIRCUMCISE
CIRCUMNAVIGATE	CIRCUMNAVIGATE
CIRCUMSCRIBES	CIRCUMSCRIBE
CIRCUMVENTS	CIRCUMVENT
CIRQUE	CIRQUE
CISAPRIDE	CISAPRIDE
CIT	CIT
CITES	CITE
CITICORP	CITICORP
CIVILIANISE	CIVILIANISE
CIVILISE	CIVILISE
CIVILIZE	CIVILIZE
CL	CL
CLA	CLA
CLACKING	CLACK
CLAD	CLAD
CLAIMS	CLAIM
CLAMS	CLAM
CLAMBERS	CLAMBER
CLAMOURS	CLAMOUR
CLAMPS	CLAMP
CLANG	CLANG
CLANGED	CLANGE
CLANK	CLANK
CLAPS	CLAP
CLARIFIES	CLARIFY
CLASHES	CLASH
CLASPS	CLASP
CLASSES	CLASS
CLASSIFIES	CLASSIFY
CLASSIQUE	CLASSIQUE
CLASSIEST	CLASSY
CLATTERS	CLATTER
CLAUDINE	CLAUDINE
CLAWS	CLAW
CLE	CLE
CLEANS	CLEAN
CLEANSES	CLEANSE
CLEARS	CLEAR
CLEAVES	CLEAVE
CLEFT	CLEFT
CLEMENZA	CLEMENZA
CLENCHES	CLENCH
CLEVEREST	CLEVER
CLI	CLI
CLICH�D	CLICH�D
CLICKS	CLICK
CLIFT	CLIFT
CLIMAXES	CLIMAX
CLIMBS	CLIMB
CLINCHES	CLINCH
CLINGS	CLING
CLINK	CLINK
CLIPS	CLIP
CLO	CLO
CLOAKS	CLOAK
CLOBBERED	CLOBBER
CLOCKS	CLOCK
CLOGS	CLOG
CLOISTERED	CLOISTER
CLOMPED	CLOMP
CLONED	CLON
CLONE	CLONE
CLONK	CLONK
CLOSES	CLOSE
CLOSEKNIT	CLOSEKNIT
CLOSETED	CLOSET
CLOTS	CLOT
CLOTHES	CLOTHE
CLOUDS	CLOUD
CLOUDIER	CLOUDY
CLOUTED	CLOUT
CLOVE	CLOVE
CLOWN	CLOWN
CLOTHING	CLTHE
CLUBBED	CLUB
CLUCKS	CLUCK
CLUED	CLUE
CLUMPED	CLUMP
CLUMSIEST	CLUMSY
CLUNKS	CLUNK
CLUSTERED	CLUSTER
CLUTCHES	CLUTCH
CLUTTERS	CLUTTER
CMI	CMI
CML	CML
CMV	CMV
CO	CO
COACHES	COACH
COAGULATES	COAGULATE
COALESCED	COALESCE
COALMINING	COALMINE
COARSEST	COARSE
COARSENED	COARSEN
COASTED	COAST
COATED	COAT
COAXES	COAX
COBBLED	COBBLE
COBWEBBED	COBWEB
COCKS	COCK
COCKFIGHTING	COCKFIGHT
COCKIER	COCKY
COCOONED	COCOON
CODDLED	CODDLE
CODES	CODE
CODENAMED	CODENAME
CODIFIES	CODIFY
COERCES	COERCE
COEUR	COEUR
COEXISTS	COEXIST
COGS	COG
COHABITED	COHABIT
COHERES	COHERE
COIFFURED	COIFFURE
COILS	COIL
COINED	COIN
COINCIDES	COINCIDE
COIRE	COIRE
COL	COL
COLDEST	COLD
COLL	COLL
COLLABORATES	COLLABORATE
COLLAPSES	COLLAPSE
COLLAR	COLLAR
COLLARED	COLLARE
COLLATES	COLLATE
COLLECTS	COLLECT
COLLECTIVIZE	COLLECTIVIZE
COLLIDES	COLLIDE
COLLOCATE	COLLOCATE
COLLUDES	COLLUDE
COLON	COLON
COLONISED	COLONISE
COLONIZED	COLONIZE
COLOURS	COLOUR
COLQUHOUN	COLQUHOUN
COM	COM
COMBS	COMB
COMBATS	COMBAT
COMBINES	COMBINE
COMBUSTED	COMBUST
COMETH	COME
COMFORTS	COMFORT
COMFIER	COMFY
COMIGRATED	COMIGRATE
COMINTERN	COMINTERN
COMM	COMM
COMMANDS	COMMAND
COMMANDEERED	COMMANDEER
COMME	COMME
COMMEDIA	COMMEDIA
COMMEMORATES	COMMEMORATE
COMMENCES	COMMENCE
COMMENDS	COMMEND
COMMENTS	COMMENT
COMMENTATE	COMMENTATE
COMMERCIALISED	COMMERCIALISE
COMMERCIALIZED	COMMERCIALIZE
COMMISERATE	COMMISERATE
COMMISSIONS	COMMISSION
COMMITS	COMMIT
COMMONEST	COMMONE
COMMUNING	COMMUNE
COMMUNICATES	COMMUNICATE
COMMUNICATION	COMMUNICATION
COMMUTES	COMMUTE
COMO	COMO
COMP	COMP
COMPACTS	COMPACT
COMPAGNIE	COMPAGNIE
COMPARES	COMPARE
COMPARTMENTED	COMPARTMENT
COMPARTMENTALISE	COMPARTMENTALISE
COMPARTMENTALIZED	COMPARTMENTALIZE
COMPELS	COMPEL
COMPENSATES	COMPENSATE
COMPERED	COMPER
COMPETES	COMPETE
COMPILES	COMPILE
COMPLAINS	COMPLAIN
COMPLEMENTS	COMPLEMENT
COMPLETES	COMPLETE
COMPL�TES	COMPL�TES
COMPLEXED	COMPLEX
COMPLICATES	COMPLICATE
COMPLICIT	COMPLICIT
COMPLIMENTS	COMPLIMENT
COMPLIES	COMPLY
COMPORT	COMPORT
COMPOSES	COMPOSE
COMPOSITION	COMPOSITION
COMPOSTED	COMPOST
COMPOUNDS	COMPOUND
COMPREHENDS	COMPREHEND
COMPRESSES	COMPRESS
COMPRISES	COMPRISE
COMPROMISED	COMPROMISE
COMPTES	COMPTES
COMPUSERVE	COMPUSERVE
COMPUTES	COMPUTE
COMPUTERISED	COMPUTERISE
COMUNISTA	COMUNISTA
CONS	CON
CONC	CONC
CONCATENATED	CONCATENATE
CONCEALS	CONCEAL
CONCEDES	CONCEDE
CONCEIVES	CONCEIVE
CONCELEBRATE	CONCELEBRATE
CONCENTRATES	CONCENTRATE
CONCEPTUALISED	CONCEPTUALISE
CONCEPTUALIZES	CONCEPTUALIZE
CONCERNS	CONCERN
CONCERNING	CONCERNING
CONCERTING	CONCERT
CONCERTANTE	CONCERTANTE
CONCILIATE	CONCILIATE
CONCLUDES	CONCLUDE
CONCOCTED	CONCOCT
CONCRETED	CONCRETE
CONCURS	CONCUR
CONCUSSED	CONCUSS
CONDE	CONDE
CONDEMNS	CONDEMN
CONDENSES	CONDENSE
CONDESCENDS	CONDESCEND
CONDITIONS	CONDITION
CONDONING	CONDON
CONDONES	CONDONE
CONDUCES	CONDUCE
CONDUCTS	CONDUCT
CONDUCTEUR	CONDUCTEUR
CONFERS	CONFER
CONFESSES	CONFESS
CONFIDES	CONFIDE
CONFIGURED	CONFIGURE
CONFINES	CONFINE
CONFIRMS	CONFIRM
CONFISCATED	CONFISCATE
CONFLATES	CONFLATE
CONFLICTS	CONFLICT
CONFORMS	CONFORM
CONFOUNDS	CONFOUND
CONFRONTS	CONFRONT
CONFUSES	CONFUSE
CONGEST	CONG
CONGAIE	CONGAIE
CONGEALS	CONGEAL
CONGRATULATES	CONGRATULATE
CONGREGATES	CONGREGATE
CONJECTURED	CONJECTURE
CONJOINED	CONJOIN
CONJUGATED	CONJUGATE
CONJURES	CONJURE
CONKED	CONK
CONNECTS	CONNECT
CONNIVED	CONNIVE
CONNOTES	CONNOTE
CONQUERS	CONQUER
CONS	CONS
CONSCRIPTED	CONSCRIPT
CONSECRATED	CONSECRATE
CONSENTS	CONSENT
CONSERVES	CONSERVE
CONSIDERS	CONSIDER
CONSIDERING	CONSIDERING
CONSIGNS	CONSIGN
CONSISTS	CONSIST
CONSOLES	CONSOLE
CONSOLIDATES	CONSOLIDATE
CONSOMM�	CONSOMM�
CONSORTS	CONSORT
CONSPIRES	CONSPIRE
CONSTANTINOPLE	CONSTANTINOPLE
CONSTANZA	CONSTANZA
CONSTANZE	CONSTANZE
CONSTIPATED	CONSTIPATE
CONSTITUTES	CONSTITUTE
CONSTRAINS	CONSTRAIN
CONSTRICTS	CONSTRICT
CONSTRUCTS	CONSTRUCT
CONSTRUES	CONSTRUE
CONSULTS	CONSULT
CONSUMES	CONSUME
CONSUMMATED	CONSUMMATE
CONT	CONT
CONTACTS	CONTACT
CONTAINS	CONTAIN
CONTAMINATES	CONTAMINATE
CONTEMPLATES	CONTEMPLATE
CONTEMPORAIN	CONTEMPORAIN
CONTENDS	CONTEND
CONTENTS	CONTENT
CONTESTS	CONTEST
CONTEXTUALISED	CONTEXTUALISE
CONTEXTUALIZED	CONTEXTUALIZE
CONTINUES	CONTINUE
CONTINUO	CONTINUO
CONTORTED	CONTORT
CONTOURED	CONTOUR
CONTRA	CONTRA
CONTRACTS	CONTRACT
CONTRADICTS	CONTRADICT
CONTRAINDICATED	CONTRAINDICATE
CONTRASTS	CONTRAST
CONTRAT	CONTRAT
CONTRAVENES	CONTRAVENE
CONTRE	CONTRE
CONTRIBUTES	CONTRIBUTE
CONTRIVES	CONTRIVE
CONTROLS	CONTROL
CONVALESCE	CONVALESCE
CONVECT	CONVECT
CONVENING	CONVEN
CONVENES	CONVENE
CONVERGES	CONVERGE
CONVERSED	CONVERSE
CONVERTS	CONVERT
CONVEYS	CONVEY
CONVICTED	CONVICT
CONVINCES	CONVINCE
CONVOKED	CONVOKE
CONVOLUTED	CONVOLUTE
CONVOY	CONVOY
CONVULSE	CONVULSE
COOING	COO
COOED	COOE
COOEE	COOEE
COOGAN	COOGAN
COOKS	COOK
COOLS	COOL
COOPED	COOP
COOPERING	COOPER
COOPERATES	COOPERATE
COOPTED	COOPT
COORDINATED	COORDINATE
COOT	COOT
COPS	COP
COPES	COPE
COPEPODS	COPEPOD
COPPICING	COPPICE
COPULATED	COPULATE
COPIES	COPY
COPYDEX	COPYDEX
COQ	COQ
COR	COR
CORD	CORD
CORDATA	CORDATA
CORDIALE	CORDIALE
CORDIFOLIA	CORDIFOLIA
CORDONED	CORDON
CORED	CORE
CORKED	CORK
CORKSCREWING	CORKSCREW
CORMS	CORM
CORNING	CORN
CORNERED	CORNER
CORNFLOWER	CORNFLOWER
CORNUS	CORNUS
CORNIEST	CORNY
CORPS	CORPS
CORPUS	CORPUS
CORRALLED	CORRAL
CORRECTS	CORRECT
CORRELATES	CORRELATE
CORRESPONDS	CORRESPOND
CORROBORATES	CORROBORATE
CORRODES	CORRODE
CORRUPTS	CORRUPT
COS	COS
COSA	COSA
COSHED	COSH
COSI	COSI
COS�	COS�
COSSETED	COSSET
COSTS	COST
COSTLIEST	COSTLY
COSTUMED	COSTUME
COSIEST	COSY
C�TE	C�TE
COTTLE	COTTLE
COTTONED	COTTON
COU	COU
COUCHED	COUCH
COUGHS	COUGH
COUL	COUL
COULD	COULD
COUN	COUN
COUNCILLED	COUNCIL
COUNSELS	COUNSEL
COUNTS	COUNT
COUNTENANCES	COUNTENANCE
COUNTERS	COUNTER
COUNTERACTS	COUNTERACT
COUNTERATTACK	COUNTERATTACK
COUNTERBALANCES	COUNTERBALANCE
COUNTERCLAIM	COUNTERCLAIM
COUNTERFEIT	COUNTERFEIT
COUNTERMANDED	COUNTERMAND
COUNTERPOINTED	COUNTERPOINT
COUNTERPOSES	COUNTERPOSE
COUNTERSIGNED	COUNTERSIGN
COUNTERSTAINED	COUNTERSTAIN
COUP	COUP
COUPERIN	COUPERIN
COUPLES	COUPLE
COUR	COUR
COURS	COURS
COURSES	COURSE
COURTS	COURT
COUTURE	COUTURE
COV	COV
COVENANTS	COVENANT
COVERS	COVER
COVETS	COVET
COVETED	COVETE
COWED	COW
COWERS	COWER
COWLED	COWL
COXING	COX
COXSWAIN	COXSWAIN
COZ	COZ
CRED	CR
CRA	CRA
CRABBING	CRAB
CRACKED	CRACK
CRACKLES	CRACKLE
CRADLED	CRADLE
CRAFTED	CRAFT
CRAFTIER	CRAFTY
CRAGANOUR	CRAGANOUR
CRAMS	CRAM
CRAMPS	CRAMP
CRANACH	CRANACH
CRANES	CRANE
CRANKED	CRANK
CRANMER	CRANM
CRANOG	CRANOG
CRAP	CRAP
CRASHES	CRASH
CRASSEST	CRASS
CRATED	CRATE
CRATERED	CRATER
CRAVES	CRAVE
CRAWLS	CRAWL
CRAYONING	CRAYON
CRAZIEST	CRAZY
CRE	CRE
CREAG	CREAG
CREAKS	CREAK
CREAMED	CREAM
CREAMIER	CREAMY
CREASES	CREASE
CREATES	CREATE
CREDITS	CREDIT
CREEPS	CREEP
CREMATED	CREMATE
CREME	CREME
CR�ME	CR�ME
CRENELLATED	CRENELLATE
CRESTED	CREST
CREWED	CREW
CRI	CRI
CRIBBING	CRIB
CRIKEY	CRIKEY
CRIMINALISED	CRIMINALISE
CRIMINALIZED	CRIMINALIZE
CRIMPED	CRIMP
CRIMSON	CRIMSON
CRINGES	CRINGE
CRINKLED	CRINKLE
CRIPS	CRIP
CRIPES	CRIPES
CRIPPLED	CRIPPLE
CRISP	CRISP
CRISSCROSSED	CRISSCROSS
CRIT	CRIT
CRITICISES	CRITICISE
CRITICIZES	CRITICIZE
CRITIQUE	CRITIQUE
CRO	CRO
CROAKS	CROAK
CROCHET	CROCHET
CROCHETING	CROCHETE
CROCKED	CROCK
CROIX	CROIX
CROOKING	CROOK
CROONS	CROON
CROPS	CROP
CROSSES	CROSS
CROSSBONES	CROSSBONE
CROSSBREEDING	CROSSBREED
CROSSLINKED	CROSSLINK
CROSSWIND	CROSSWIND
CROUCHES	CROUCH
CROWED	CROW
CROWDED	CROWD
CROWE	CROWE
CROWNS	CROWN
CRU	CRU
CRUCIFIED	CRUCIFY
CRUCIS	CRUCIS
CRUDEST	CRUDE
CRUELLEST	CRUEL
CRUISES	CRUISE
CRUMBLES	CRUMBLE
CRUMPLES	CRUMPLE
CRUNCHES	CRUNCH
CRUSADE	CRUSADE
CRUSE	CRUSE
CRUSHES	CRUSH
CRUSTED	CRUST
CRUSTIER	CRUSTY
CRUZEIROS	CRUZEIRO
CRIES	CRY
CRYSTALLISES	CRYSTALLISE
CRYSTALLIZES	CRYSTALLIZE
CS	CS
CU	CU
CUBED	CUBE
CUBISME	CUBISME
CUCKOLDED	CUCKOLD
CUDDLES	CUDDLE
CUDGELLED	CUDGEL
CUED	CUE
CUFFS	CUFF
CUISINE	CUISINE
CUL	CUL
CULLED	CULL
CULMINATES	CULMINATE
CULPA	CULPA
CULTISH	CULTISH
CULTIVATES	CULTIVATE
CULTURALI	CULTURALI
CULTURED	CULTURE
CULVERTED	CULVERT
CUM	CUM
CUMULATES	CUMULATE
CUPS	CUP
CUR	CUR
CURATED	CURATE
CURBS	CURB
CURDLES	CURDLE
CURES	CURE
CURIOUSER	CURIOUS
CURLS	CURL
CURLIER	CURLY
CURRY	CURRY
CURSES	CURSE
CURTAILS	CURTAIL
CURTAINED	CURTAIN
CURTSEY	CURTSEY
CURTSIED	CURTSY
CURVES	CURVE
CURVIER	CURVY
CUSACK	CUSACK
CUSHIONS	CUSHION
CUSSING	CUSS
CUSTOMISED	CUSTOMISE
CUSTOMIZED	CUSTOMIZE
CUTS	CUT
CUTEST	CUTE
CUZCO	CUZCO
CV	CV
CX	CX
CYCLES	CYCLE
CYTOKINES	CYTOKINE
CYTR	CYTR
D	D
DA	DA
DABBED	DAB
DABBLES	DABBLE
DAE	DAE
DAF	DAF
DAFTEST	DAFT
DAH	DAH
DAINTIEST	DAINTY
DAL	DAL
DALGLIESH	DALGLIESH
DALLIED	DALLY
DAMMED	DAM
DAMAGES	DAMAGE
DAME	DAME
DAMMIT	DAMMIT
DAMNS	DAMN
DAMNEDEST	DAMNEDE
DAMPED	DAMP
DAMPENS	DAMPEN
DAN	DAN
DANCES	DANCE
DANDLED	DANDLE
DANGLES	DANGLE
DANIEL	DANIEL
DANKER	DANK
DANS	DANS
DANSE	DANSE
DANSEUSE	DANSEUSE
DAPHNIS	DAPHNIS
DAPPLED	DAPPLE
DAR	DAR
DARES	DARE
DAREDEVIL	DAREDEVIL
DARESAY	DARESAY
DARKEST	DARK
DARKENS	DARKEN
DARNED	DARN
DARTS	DART
DAS	DAS
DASHES	DASH
DAT	DAT
DATABASING	DATABASE
DATES	DATE
DATELINE	DATELINE
DATUK	DATUK
DAUBED	DAUB
DAUNTED	DAUNT
DAVERS	DAVER
DAVIDE	DAVIDE
DAVIDOFF	DAVIDOFF
DAWDLES	DAWDLE
DAWNS	DAWN
DAWYCK	DAWYCK
DAY	DAY
DAYDREAM	DAYDREAM
DAYSACK	DAYSACK
DAZ	DAZ
DAZED	DAZE
DAZZLES	DAZZLE
DCC	DCC
DCI	DCI
DCL	DCL
DE	DE
DEACCESSIONED	DEACCESSION
DEACTIVATES	DEACTIVATE
DEADEST	DEAD
DEADENS	DEADEN
DEADLOCKED	DEADLOCK
DEADLIEST	DEADLY
DEAFER	DEAF
DEAFENS	DEAFEN
DEALS	DEAL
DEAR	DEAR
DEB	DEB
DEBARRED	DEBAR
DEBASED	DEBASE
DEBATED	DEBATE
DEBAUCH	DEBAUCH
DEBILITATED	DEBILITATE
DEBITS	DEBIT
DEBOUCHES	DEBOUCH
DEBRIEFED	DEBRIEF
DEBUG	DEBUG
DEBUNKS	DEBUNK
DEBUT	DEBUT
DEBUTED	DEBUTE
DEC	DEC
DECAMPS	DECAMP
DECANTED	DECANT
DECAPITATED	DECAPITATE
DECAYS	DECAY
DECEIVES	DECEIVE
DECELERATED	DECELERATE
DECENTRALISED	DECENTRALISE
DECENTRALIZED	DECENTRALIZE
DECIDES	DECIDE
DECIMATED	DECIMATE
DECIPHERED	DECIPHER
DECKED	DECK
DECLAIMS	DECLAIM
DECLARES	DECLARE
DECLINES	DECLINE
DECO	DECO
DECODES	DECODE
DECOMMISSIONED	DECOMMISSION
DECOMPOSES	DECOMPOSE
DECOMPRESSED	DECOMPRESS
DECONSTRUCTS	DECONSTRUCT
DECONTAMINATE	DECONTAMINATE
DECONTROLLED	DECONTROL
DECORATES	DECORATE
D�CORATIFS	D�CORATIFS
DECOUPLED	DECOUPLE
DECREASES	DECREASE
DECREES	DECREE
DECRIES	DECRY
DEDICATES	DEDICATE
DEDUCES	DEDUCE
DEDUCTS	DEDUCT
DEE	DEE
DEEMS	DEEM
DEEPEST	DEEP
DEEPENS	DEEPEN
DEEPWATER	DEEPWATE
DEF	DEF
DEFACED	DEFACE
DEFAMES	DEFAME
DEFAULTS	DEFAULT
DEFEATS	DEFEAT
DEFECATE	DEFECATE
DEFECTS	DEFECT
DEFENCE	DEFENCE
DEFENDS	DEFEND
DEFERS	DEFER
DEFILES	DEFILE
DEFINES	DEFINE
DEFLATES	DEFLATE
DEFLECTS	DEFLECT
DEFLOWERED	DEFLOWER
DEFOLIATING	DEFOLIATE
DEFORMS	DEFORM
DEFRAUDED	DEFRAUD
DEFRAYED	DEFRAY
DEFROSTS	DEFROST
DEFUSES	DEFUSE
DEFIES	DEFY
DEGENERATES	DEGENERATE
DEGRADES	DEGRADE
DEHUMANISES	DEHUMANISE
DEHUMANIZING	DEHUMANIZE
DEHYDRATES	DEHYDRATE
DEI	DEI
DEIFIED	DEIFY
DEIGNS	DEIGN
DEIN	DEIN
DEJA	DEJA
D�J�	D�J�
DEL	DEL
DELAYS	DELAY
DELEGATES	DELEGATE
DELETES	DELETE
DELEUZE	DELEUZE
DELI	DELI
DELIBERATES	DELIBERATE
DELIGHTS	DELIGHT
DELILAH	DELILAH
DELIMITS	DELIMIT
DELINEATING	DELINEAT
DELINEATES	DELINEATE
DELIRIUM	DELIRIUM
DELISTED	DELIST
DELIVERS	DELIVER
DELLA	DELLA
DELLE	DELLE
DELO	DELO
DELUDED	DELUDE
DELUGED	DELUGE
DELVES	DELVE
DEMS	DEM
DEMAIN	DEMAIN
DEMANDS	DEMAND
DEMARCATES	DEMARCATE
DEMATERIALISE	DEMATERIALISE
DEMEANS	DEMEAN
DEMENTING	DEMENT
DEMERGE	DEMERGE
DEMISED	DEMISE
DEMOING	DEMO
DEMOBBED	DEMOB
DEMOBILISED	DEMOBILISE
DEMOBILIZED	DEMOBILIZE
D�MOCRATES	D�MOCRATES
DEMOCRATIC	DEMOCRATIC
D�MOCRATIE	D�MOCRATIE
D�MOCRATIQUE	D�MOCRATIQUE
DEMOCRATISED	DEMOCRATISE
DEMOCRATIZED	DEMOCRATIZE
DEMOISELLES	DEMOISELLES
DEMOLISHES	DEMOLISH
DEMONSTRATES	DEMONSTRATE
DEMORALISE	DEMORALISE
DEMORALIZED	DEMORALIZE
DEMOS	DEMOS
DEMOTED	DEMOTE
DEMURS	DEMUR
DEMYSTIFIES	DEMYSTIFY
DEN	DEN
DENATURED	DENATURE
DENIGRATES	DENIGRATE
DENOMINATED	DENOMINATE
DENOTES	DENOTE
DENOUNCES	DENOUNCE
DENSEST	DENS
DENTS	DENT
DENTE	DENTE
DENTURES	DENTURE
DENUDED	DENUDE
DENYS	DENY
DEO	DEO
DEP	DEP
DEPARTS	DEPART
DEPENDS	DEPEND
DEPERSONALISING	DEPERSONALISE
DEPERSONALIZED	DEPERSONALIZE
DEPICTS	DEPICT
DEPLETES	DEPLETE
DEPLORES	DEPLORE
DEPLOYS	DEPLOY
DEPOLARIZED	DEPOLARIZE
DEPOPULATED	DEPOPULATE
DEPORTED	DEPORT
DEPOSES	DEPOSE
DEPOSITS	DEPOSIT
DEPRAVED	DEPRAVE
DEPRECATES	DEPRECATE
DEPRECIATES	DEPRECIATE
DEPRESSES	DEPRESS
DEPRIVES	DEPRIVE
DEPUTED	DEPUTE
DEPUTISES	DEPUTISE
DEPUTIZING	DEPUTIZE
DEPUTY	DEPUTY
DER	DER
DERAILED	DERAIL
DERANGED	DERANGE
DERE	DERE
DEREGISTERED	DEREGISTER
DEREGULATED	DEREGULATE
DERIDES	DERIDE
DERIVES	DERIVE
DEROGATED	DEROGATE
DERRICK	DERRICK
DES	DES
DESCENDS	DESCEND
DESCRIBES	DESCRIBE
DESCRIED	DESCRY
DESECRATED	DESECRATE
DESELECTED	DESELECT
DESENSITIZE	DESENSITIZE
DESERTS	DESERT
DESERVES	DESERVE
DESI	DESI
DESIGNED	DESIGN
DESIGNATES	DESIGNATE
DESIRES	DESIRE
DESISTS	DESIST
DESKILLED	DESKIL
DESPAIRED	DESPAIR
DESPATCHED	DESPATCH
DESPISES	DESPISE
DESPITE	DESPITE
DESPOILED	DESPOIL
DESSIN	DESSIN
DESTABILISES	DESTABILISE
DESTABILIZES	DESTABILIZE
DESTINED	DESTINE
DESTROYS	DESTROY
DET	DET
DETACHES	DETACH
DETAILS	DETAIL
DETAINED	DETAIN
DETECTS	DETECT
DETERS	DETER
DETERIORATES	DETERIORATE
DETERMINES	DETERMINE
DETESTS	DETEST
DETH	DETH
DETHRONED	DETHRON
DETONATED	DETONATE
DETOUR	DETOUR
DETOXED	DETOX
DETOXIFIED	DETOXIFY
DETRACTS	DETRACT
DETTOL	DETTOL
DEUM	DEUM
DEUS	DEUS
DEUTSCH	DEUTSCH
DEUTSCHE	DEUTSCHE
DEUX	DEUX
DEV	DEV
DEVALUES	DEVALUE
DEVANT	DEVANT
DEVASTATES	DEVASTATE
DEVELOPS	DEVELOP
DEVERAUGH	DEVERAUGH
DEVIATES	DEVIATE
DEVISES	DEVISE
DEVOLVES	DEVOLVE
DEVONPORT	DEVONPORT
DEVOTES	DEVOTE
DEVOURS	DEVOUR
DEWED	DEW
DEXAMETHASONE	DEXAMETHASONE
DEY	DEY
DHIA	DHIA
DI	DI
DIA	DIA
DIAGNOSES	DIAGNOSE
DIAGRAMMED	DIAGRAM
DIALS	DIAL
DIALLING	DIALL
DIALYSED	DIALYSE
DIAS	DIAS
DIC	DIC
DICED	DICE
DICHOTOMIZE	DICHOTOMIZE
DICKERING	DICKER
DICTATES	DICTATE
DICTIONNAIRE	DICTIONNAIRE
DID	DID
DIDDLED	DIDDLE
DIDN	DIDN
DIDST	DIDST
DIDIER	DIDY
DIES	DIE
DIEM	DIEM
DIES	DIES
DIETED	DIET
DIEU	DIEU
DIF	DIF
DIFF	DIFF
DIFFERS	DIFFER
DIFFERENCING	DIFFERENCE
DIFFERENTIATES	DIFFERENTIATE
DIFFUSES	DIFFUSE
DIGS	DIG
DIGESTS	DIGEST
DIGITECH	DIGITECH
DIGITISE	DIGITISE
DIGITIZED	DIGITIZE
DIGNIFY	DIGNIFY
DIGRESSED	DIGRESS
DIII	DIII
DILATES	DILATE
DILLIED	DILLY
DILUTES	DILUTE
DIMS	DIM
DIMENSIONED	DIMENSION
DIMINISHES	DIMINISH
DIMPLING	DIMPLE
DINNED	DIN
DINAH	DINAH
DINES	DINE
DING	DING
DINIZ	DINIZ
DIOS	DIOS
DIPS	DIP
DIR	DIR
DIRE	DIRE
DIRECTS	DIRECT
DIRTIES	DIRTY
DIS	DIS
DISABLES	DISABLE
DISABUSED	DISABUSE
DISADVANTAGED	DISADVANTAGE
DISAFFILIATED	DISAFFILIATE
DISAFFORESTED	DISAFFOREST
DISAGGREGATED	DISAGGREGATE
DISAGREES	DISAGREE
DISALLOWS	DISALLOW
DISAMBIGUATED	DISAMBIGUATE
DISAPPEARS	DISAPPEAR
DISAPPLIED	DISAPPLY
DISAPPOINTS	DISAPPOINT
DISAPPROVES	DISAPPROVE
DISARMS	DISARM
DISASSEMBLED	DISASSEMBLE
DISASSOCIATED	DISASSOCIATE
DISAVOWED	DISAVOW
DISBANDS	DISBAND
DISBARRED	DISBAR
DISBELIEVED	DISBELIEVE
DISBURSED	DISBURSE
DISC	DISC
DISCARDS	DISCARD
DISCERNS	DISCERN
DISCHARGES	DISCHARGE
DISCIPLING	DISCIPLE
DISCIPLINES	DISCIPLINE
DISCLAIMS	DISCLAIM
DISCLOSES	DISCLOSE
DISCOLOURED	DISCOLOUR
DISCOMFITED	DISCOMFIT
DISCOMFORTED	DISCOMFORT
DISCONCERTED	DISCONCERT
DISCONFIRMED	DISCONFIRM
DISCONNECTS	DISCONNECT
DISCONTINUED	DISCONTINUE
DISCOUNTS	DISCOUNT
DISCOURAGES	DISCOURAGE
DISCOURSING	DISCOURSE
DISCOVERS	DISCOVER
DISCREDITS	DISCREDIT
DISCRIMINATES	DISCRIMINATE
DISCUSSES	DISCUSS
DISDAINS	DISDAIN
DISEMBARKED	DISEMBARK
DISEMBODIED	DISEMBODY
DISEMBOWELLED	DISEMBOWEL
DISEMPOWERS	DISEMPOWER
DISENFRANCHISES	DISENFRANCHISE
DISENGAGES	DISENGAGE
DISENTANGLED	DISENTANGLE
DISENTITLED	DISENTITLE
DISESTABLISHED	DISESTABLISH
DISFAVOURED	DISFAVOUR
DISFIGURES	DISFIGURE
DISGORGED	DISGORGE
DISGRACED	DISGRACE
DISGUISES	DISGUISE
DISGUSTS	DISGUST
DISHED	DISH
DISHEARTENED	DISHEARTEN
DISHONOURS	DISHONOUR
DISHWASHING	DISHWASH
DISILLUSIONED	DISILLUSION
DISINFECTED	DISINFECT
DISINHERITED	DISINHERIT
DISINTEGRATES	DISINTEGRATE
DISINTERRED	DISINTER
DISLIKES	DISLIKE
DISLOCATED	DISLOCATE
DISLODGES	DISLODGE
DISMANTLES	DISMANTLE
DISMAYED	DISMAY
DISMEMBERED	DISMEMBER
DISMISSES	DISMISS
DISMOUNTED	DISMOUNT
DISOBEYS	DISOBEY
DISORGANISED	DISORGANISE
DISORGANIZED	DISORGANIZE
DISORIENTING	DISORIENT
DISORIENTATE	DISORIENTATE
DISOWNS	DISOWN
DISPARAGES	DISPARAGE
DISPASSIONATE	DISPASSIONATE
DISPATCHES	DISPATCH
DISPELS	DISPEL
DISPENSES	DISPENSE
DISPERSES	DISPERSE
DISPIRITED	DISPIRIT
DISPLACES	DISPLACE
DISPLAYS	DISPLAY
DISPLEASES	DISPLEASE
DISPORTING	DISPORT
DISPOSES	DISPOSE
DISPOSSESSED	DISPOSSESS
DISPROVES	DISPROVE
DISPUTES	DISPUTE
DISQUALIFIES	DISQUALIFY
DISQUIETED	DISQUIET
DISREGARDS	DISREGARD
DISROBING	DISROBE
DISRUPTS	DISRUPT
DISSING	DISS
DISSECTS	DISSECT
DISSEMBLE	DISSEMBLE
DISSEMINATES	DISSEMINATE
DISSENTS	DISSENT
DISSIPATES	DISSIPATE
DISSOCIATES	DISSOCIATE
DISSOLVES	DISSOLVE
DISSUADES	DISSUADE
DISTANCES	DISTANCE
DISTENDED	DISTEND
DISTILS	DISTIL
DISTINGUISHES	DISTINGUISH
DISTORTS	DISTORT
DISTRACTS	DISTRACT
DISTRAINED	DISTRAIN
DISTRESSED	DISTRESS
DISTRIBUTES	DISTRIBUTE
DISTRUSTS	DISTRUST
DISTURBS	DISTURB
DIT	DIT
DITCHES	DITCH
DITHERS	DITHER
DIV	DIV
DIVES	DIVE
DIVERGES	DIVERGE
DIVERSIFIES	DIVERSIFY
DIVERTS	DIVERT
DIVESTS	DIVEST
DIVI	DIVI
DIVIDES	DIVIDE
DIVINES	DIVINE
DIVORCES	DIVORCE
DIVULGES	DIVULGE
DIVVIED	DIVVY
DIX	DIX
DIZZIED	DIZZY
DJING	DJ
DL	DL
DLV	DLV
DNASE	DNASE
DNESTR	DNESTR
DOING	DO
DOC	DOC
DOCKED	DOCK
DOCTOR	DOCTOR
DOCTORED	DOCTORE
DOCUMENTS	DOCUMENT
DOCUMENTATION	DOCUMENTATION
DODGES	DODGE
DODGIER	DODGY
DOE	DOE
DOES	DOES
DOFFING	DOFF
DOGS	DOG
DOI	DOI
DOKE	DOKE
DOKEY	DOKEY
DOLCE	DOLCE
DOLED	DOLE
DOLLED	DOLL
DOLLAR	DOLLAR
DOLORES	DOLORE
DOM	DOM
DOMED	DOME
DOMESTICATE	DOMESTICATE
DOMICILED	DOMICILE
DOMINATES	DOMINATE
DOMINE	DOMINE
DOMINEERING	DOMINEER
DOMINI	DOMINI
DOMINUS	DOMINUS
DONS	DON
DONA	DONA
DONATES	DONATE
DONG	DONG
DONNA	DONNA
DONNAS	DONNAS
DONOGHUE	DONOGHUE
DOO	DOO
DOODLE	DOODLE
DOOMED	DOOM
DOON	DOON
DOPED	DOPE
DORNING	DORN
DORT	DORT
DOS	DOS
DOSED	DOSE
DOSS	DOSS
DOSSIER	DOSSY
DOST	DOST
DOTTED	DOT
DOTES	DOTE
DOUBLES	DOUBLE
DOUBTS	DOUBT
DOUCEUR	DOUCEUR
DOUNREAY	DOUNREAY
DOUSES	DOUSE
DOUX	DOUX
DOVECOT	DOVECOT
DOVETAILS	DOVETAIL
DOW	DOW
DOWDING	DOWD
DOWELLED	DOWEL
DOWNED	DOWN
DOWNGRADES	DOWNGRADE
DOWNHEARTED	DOWNHEART
DOWNLOADED	DOWNLOAD
DOWNPLAYS	DOWNPLAY
DOWNSIZED	DOWNSIZE
DOWSED	DOWSE
DOZED	DOZE
DOZEN	DOZEN
DOZENS	DOZENS
DR	DR
DRA	DRA
DRABBER	DRAB
DRACHENFELS	DRACHENFEL
DRAFTS	DRAFT
DRAGS	DRAG
DRAGOONED	DRAGOON
DRAINS	DRAIN
DRAMATISES	DRAMATISE
DRAMATIZES	DRAMATIZE
DRANG	DRANG
DRAPES	DRAPE
DRAT	DRAT
DRAUGHTING	DRAUGHT
DRAUGHTPROOF	DRAUGHTPROOF
DRAWS	DRAW
DRAWLS	DRAWL
DREADS	DREAD
DREAMS	DREAM
DREARIEST	DREARY
DREDGES	DREDGE
DRENCHED	DRENCH
DRESSES	DRESS
DREXEL	DREXEL
DRI	DRI
DRIBBLES	DRIBBLE
DRIFTS	DRIFT
DRILLS	DRILL
DRINKS	DRINK
DRIPS	DRIP
DRIVES	DRIVE
DRO	DRO
DROIT	DROIT
DRONING	DRON
DRONES	DRONE
DROOLS	DROOL
DROOPS	DROOP
DROPS	DROP
DROWNS	DROWN
DROWSING	DROWSE
DRU	DRU
DRUBBING	DRUB
DRUDGE	DRUDGE
DRUGS	DRUG
DRUMS	DRUM
DRUNKER	DRUNK
DRYS	DRY
DS	DS
DU	DU
D�	D�
DUALLED	DUALL
DUBS	DUB
DUC	DUC
DUCES	DUCE
DUCKED	DUCK
DUCTING	DUCT
DUE	DUE
DUELLING	DUELL
DUETTING	DUET
DUFF	DUFF
DULLS	DULL
DUM	DUM
DUMBFOUNDED	DUMBFOUND
DUMMIED	DUMMY
DUMPS	DUMP
DUMPIER	DUMPY
DUN	DUN
DUNKED	DUNK
DUNMURRY	DUNMURRY
DUPES	DUPE
DUPLICATES	DUPLICATE
DUPONT	DUPONT
DUR	DUR
DURABLES	DURABLE
DURHAM	DURHAM
DURING	DURING
DUSTS	DUST
DUSTIER	DUSTY
DV	DV
DVI	DVI
DWARFS	DWARF
DWELLS	DWELL
DWINDLES	DWINDLE
DX	DX
DYES	DYE
E	E
EA	EA
EACH	EACH
EACHUINN	EACHUINN
EAGLED	EAGLE
EAMONN	EAMONN
EAR	EAR
EARLIEST	EARLY
EARMARKS	EARMARK
EARNS	EARN
EARTHED	EARTH
EARTHIER	EARTHY
EARWIGGING	EARWIG
EAS	EAS
EASES	EASE
EASIEST	EASY
EATS	EAT
EAU	EAU
EAVESDROPS	EAVESDROP
EBBING	EB
EBBED	EBB
EBENSTEN	EBENSTEN
EC	EC
ECHOES	ECHO
ECLIPSES	ECLIPSE
ECOLE	ECOLE
�COLE	�COLE
ECOMOG	ECOMOG
ECON	ECON
ECONOMISED	ECONOMISE
ECONOMIZE	ECONOMIZE
ED	ED
EDD	EDD
EDDY	EDDY
EDGES	EDGE
EDGIER	EDGY
EDIFY	EDIFY
EDITS	EDIT
EDUCATES	EDUCATE
EE	EE
EEZ	EEZ
EF	EF
EFFACED	EFFACE
EFFECTS	EFFECT
EFFEMINATE	EFFEMINATE
EFL	EFL
EGGING	EG
EGF	EGF
EGGED	EGG
EGGAR	EGGAR
EGO	EGO
EH	EH
EI	EI
EICHENBAUM	EICHENBAUM
EYING	EIE
EIG	EIG
EIGH	EIGH
EIGHT	EIGHT
EIGHTEEN	EIGHTEEN
EIGHTEENTH	EIGHTEENTH
EIGHTH	EIGHTH
EIGHTHS	EIGHTHS
EIGHTIES	EIGHTIES
EIGHTIETH	EIGHTIETH
EIGHTS	EIGHTS
EIGHTY	EIGHTY
EIN	EIN
EINE	EINE
EIT	EIT
EJACULATED	EJACULATE
EJECTS	EJECT
EKED	EK
EKES	EKE
EL	EL
ELABORATES	ELABORATE
ELAPSES	ELAPSE
ELASTICATED	ELASTICATE
ELBOWS	ELBOW
ELDER	ELDER
ELDEST	ELDEST
ELE	ELE
ELEC	ELEC
ELECTS	ELECT
ELECTIONEERING	ELECTIONEER
ELECTRIFIED	ELECTRIFY
ELECTROCUTED	ELECTROCUTE
ELECTRODES	ELECTRODE
ELECTROPHORESED	ELECTROPHORESE
ELECTROPLATING	ELECTROPLATE
ELEVATES	ELEVATE
ELEVEN	ELEVEN
ELEVENS	ELEVENS
ELEVENTH	ELEVENTH
ELFED	ELF
ELICITS	ELICIT
ELIDES	ELIDE
ELIMINATES	ELIMINATE
ELLS	ELL
ELLE	ELLE
ELLES	ELLES
ELOISE	ELOISE
ELONEX	ELONEX
ELONGATE	ELONGATE
ELOPED	ELOPE
ELP	ELP
ELSES	ELSE
ELT	ELT
ELUCIDATES	ELUCIDATE
ELUDES	ELUDE
ELUTED	ELUTE
EM	EM
EMACIATED	EMACIATE
EMAIL	EMAIL
EMANATES	EMANATE
EMANCIPATED	EMANCIPATE
EMASCULATES	EMASCULATE
EMBALMED	EMBALM
EMBARGOED	EMBARGOE
EMBARKS	EMBARK
EMBARRASSES	EMBARRASS
EMBATTLED	EMBATTLE
EMBEDS	EMBED
EMBELLISHES	EMBELLISH
EMBEZZLED	EMBEZZLE
EMBITTERED	EMBITTER
EMBLAZONED	EMBLAZON
EMBODIES	EMBODY
EMBOLDENED	EMBOLDEN
EMBOSSED	EMBOSS
EMBRACES	EMBRACE
EMBROIDERED	EMBROIDER
EMBROILED	EMBROIL
EMENDED	EMEND
EMERGES	EMERGE
EMIGRATES	EMIGRATE
EMIL	EMIL
EMINENCE	EMINENCE
EMITS	EMIT
EMM	EMM
EMP	EMP
EMPATHISE	EMPATHISE
EMPATHIZE	EMPATHIZE
EMPHASISES	EMPHASISE
EMPHASIZES	EMPHASIZE
EMPLACED	EMPLACE
EMPLOYS	EMPLOY
EMPLOYEE	EMPLOYEE
EMPOWERS	EMPOWER
EMPTOR	EMPTOR
EMPTIES	EMPTY
EMULATES	EMULATE
EMULSIFIES	EMULSIFY
EMULSIONED	EMULSION
EMYR	EMYR
EN	EN
ENABLES	ENABLE
ENACTS	ENACT
ENAMELLED	ENAMEL
ENCAMPED	ENCAMP
ENCAPSULATES	ENCAPSULATE
ENCASED	ENCASE
ENCASHED	ENCASH
ENCHANTS	ENCHANT
ENCIRCLES	ENCIRCLE
ENCLOSES	ENCLOSE
ENCODES	ENCODE
ENCOMPASSES	ENCOMPASS
ENCORE	ENCORE
ENCOUNTERS	ENCOUNTER
ENCOURAGES	ENCOURAGE
ENCROACHES	ENCROACH
ENCRUSTED	ENCRUST
ENCRYPT	ENCRYPT
ENCUMBERED	ENCUMBER
ENDS	END
ENDANGERS	ENDANGER
ENDEARS	ENDEAR
ENDEAVOURS	ENDEAVOUR
ENDORSES	ENDORSE
ENDOWS	ENDOW
ENDURES	ENDURE
ENERGISED	ENERGISE
ENERGIZES	ENERGIZE
ENERVATED	ENERVATE
ENFANT	ENFANT
ENFANTS	ENFANTS
ENFEEBLED	ENFEEBLE
ENFOLDS	ENFOLD
ENFORCES	ENFORCE
ENFRANCHISED	ENFRANCHISE
ENG	ENG
ENGAGES	ENGAGE
ENGELS	ENGEL
ENGENDERS	ENGENDER
ENGINED	ENGINE
ENGINEERED	ENGINEER
ENGLAND	ENGLAND
ENGLISHING	ENGLISH
ENGORGED	ENGORGE
ENGRAVED	ENGRAVE
ENGROSSED	ENGROSS
ENGULFS	ENGULF
ENHANCES	ENHANCE
ENJOINS	ENJOIN
ENJOYS	ENJOY
ENLARGES	ENLARGE
ENLIGHTENS	ENLIGHTEN
ENLISTS	ENLIST
ENLIVENS	ENLIVEN
ENMESHED	ENMESH
ENNOBLED	ENNOBLE
ENO	ENO
ENQUIRES	ENQUIRE
ENRAGED	ENRAGE
ENRAPTURED	ENRAPTURE
ENRICHES	ENRICH
ENROLS	ENROL
ENSCONCED	ENSCONCE
ENSEMBLE	ENSEMBLE
ENSHRINES	ENSHRINE
ENSHROUDS	ENSHROUD
ENSIGN	ENSIGN
ENSLAVES	ENSLAVE
ENSNARES	ENSNARE
ENSUES	ENSUE
ENSURES	ENSURE
ENT	ENT
ENTAILS	ENTAIL
ENTANGLES	ENTANGLE
ENTENDRE	ENTENDRE
ENTENTE	ENTENTE
ENTERS	ENTER
ENTERTAINS	ENTERTAIN
ENTF�HRUNG	ENTF�HRUNG
ENTHRALLED	ENTHRAL
ENTHRONED	ENTHRON
ENTHUSES	ENTHUSE
ENTICES	ENTICE
ENTITLES	ENTITLE
ENTOMBED	ENTOMB
ENTRAINED	ENTRAIN
ENTRANCED	ENTRANCE
ENTRAPPED	ENTRAP
ENTRE	ENTRE
ENTREATED	ENTREAT
ENTR�E	ENTR�E
ENTRENCHED	ENTRENCH
ENTRUSTS	ENTRUST
ENTWINED	ENTWINE
ENUMERATES	ENUMERATE
ENUNCIATES	ENUNCIATE
ENURE	ENURE
ENVELOPS	ENVELOP
ENVELOPE	ENVELOPE
ENVER	ENVER
ENVIRONMENT	ENVIRONMENT
ENVISAGES	ENVISAGE
ENVISIONS	ENVISION
ENVIES	ENVY
EOSINOPHILS	EOSINOPHIL
EPHRAIM	EPHRAIM
EPITOMISES	EPITOMISE
EPITOMIZES	EPITOMIZE
EPITOT	EPITOT
EPRDF	EPRDF
EQ	EQ
EQUALS	EQUAL
EQUALISED	EQUALISE
EQUALIZED	EQUALIZE
EQUATES	EQUATE
EQUILIBRATED	EQUILIBRATE
EQUIPS	EQUIP
EQUIVOCATED	EQUIVOCATE
ERRING	ER
ERADICATES	ERADICATE
ERASES	ERASE
ERCELDOUN	ERCELDOUN
ERCP	ERCP
ERE	ERE
ERECTS	ERECT
ERM	ERM
ERMENTRUDE	ERMENTRUDE
ERODES	ERODE
ERRS	ERR
ERSKINE	ERSKINE
ERUPTS	ERUPT
ES	ES
ESCALATES	ESCALATE
ESCAPES	ESCAPE
ESCHEWS	ESCHEW
ESCORTS	ESCORT
ESH	ESH
ESL	ESL
ESPA�A	ESPA�A
ESPA�OL	ESPA�OL
ESPECIALLY	ESPECIALLY
ESPOUSES	ESPOUSE
ESPRIT	ESPRIT
ESPIED	ESPY
ESS	ESS
ESSAYED	ESSAY
ESSE	ESSE
ESSEN	ESSEN
EST	EST
ESTABLISHES	ESTABLISH
ESTE	ESTE
ESTEEMS	ESTEEM
ESTIMATES	ESTIMATE
ESTO	ESTO
ESTOPPED	ESTOP
ET	ET
ETCHES	ETCH
ETH	ETH
ETOILE	ETOILE
�TRE	�TRE
ETUDES	ETUDES
EULOGISING	EULOGISE
EUNICE	EUNICE
EUREKA	EUREKA
EURO	EURO
EUSTACE	EUSTACE
EV	EV
EVACUATES	EVACUATE
EVADES	EVADE
EVALUATES	EVALUATE
EVANGELISED	EVANGELISE
EVANGELIZE	EVANGELIZE
EVAPORATES	EVAPORATE
EVE	EVE
EVENS	EVEN
EVENSONG	EVENSONG
EVENTUATE	EVENTUATE
EVERS	EVER
EVEREX	EVEREX
EVERY	EVERY
EVERYBODY	EVERYBODY
EVERYONE	EVERYONE
EVERYTHING	EVERYTHING
EVICTS	EVICT
EVIDENCED	EVIDENCE
EVINCES	EVINCE
EVISCERATED	EVISCERATE
EVOKES	EVOKE
EVOLVES	EVOLVE
EWS	EW
EX	EX
EXACERBATES	EXACERBATE
EXACTS	EXACT
EXAGGERATES	EXAGGERATE
EXALTS	EXALT
EXAM	EXAM
EXAMINES	EXAMINE
EXAMPLED	EXAMPLE
EXASPERATES	EXASPERATE
EXC	EXC
EXCALIBUR	EXCALIBUR
EXCAVATES	EXCAVATE
EXCEEDS	EXCEED
EXCELS	EXCEL
EXCELLENCE	EXCELLENCE
EXCEPTS	EXCEPT
EXCEPTING	EXCEPTING
EXCERPTED	EXCERPT
EXCHANGES	EXCHANGE
EXCISED	EXCISE
EXCITING	EXCIT
EXCITES	EXCITE
EXCLAIMS	EXCLAIM
EXCLUDES	EXCLUDE
EXCLUDING	EXCLUDING
EXCLUSION	EXCLUSION
EXCOMMUNICATES	EXCOMMUNICATE
EXCORIATED	EXCORIATE
EXCRETED	EXCRETE
EXCULPATE	EXCULPATE
EXCUSES	EXCUSE
EXECUTES	EXECUTE
EXEMPLIFIES	EXEMPLIFY
EXEMPTS	EXEMPT
EXERCISES	EXERCISE
EXERTS	EXERT
EXEUNT	EXEUNT
EXFOLIATE	EXFOLIATE
EXHALES	EXHALE
EXHAUSTS	EXHAUST
EXHIBITS	EXHIBIT
EXHORTS	EXHORT
EXHUMED	EXHUME
EXILED	EXILE
EXISTS	EXIST
EXITS	EXIT
EXONERATES	EXONERATE
EXORCISED	EXORCISE
EXORCIZED	EXORCIZE
EXP	EXP
EXPANDS	EXPAND
EXPATIATE	EXPATIATE
EXPECTS	EXPECT
EXPEDITED	EXPEDIT
EXPEDITE	EXPEDITE
EXPELS	EXPEL
EXPENDS	EXPEND
EXPENSED	EXPENSE
EXPERIENCES	EXPERIENCE
EXPERIMENTS	EXPERIMENT
EXPIATE	EXPIATE
EXPIRES	EXPIRE
EXPLAINS	EXPLAIN
EXPLICATED	EXPLICATE
EXPLODES	EXPLODE
EXPLOITED	EXPLOIT
EXPLORES	EXPLORE
EXPORTS	EXPORT
EXPOSES	EXPOSE
EXPOS�	EXPOS�
EXPOSTULATE	EXPOSTULATE
EXPOUNDS	EXPOUND
EXPRESSES	EXPRESS
EXPROPRIATED	EXPROPRIATE
EXPUNGED	EXPUNGE
EXT	EXT
EXTENDS	EXTEND
EXTERMINATED	EXTERMINATE
EXTERNALIZED	EXTERNALIZE
EXTINGUISHES	EXTINGUISH
EXTIRPATED	EXTIRPATE
EXTOLS	EXTOL
EXTORTS	EXTORT
EXTRACTS	EXTRACT
EXTRADITED	EXTRADIT
EXTRADITE	EXTRADITE
EXTRAPOLATES	EXTRAPOLATE
EXTREMEST	EXTREME
EXTREMIS	EXTREMIS
EXTRICATED	EXTRICATE
EXTROVERTED	EXTROVERT
EXTRUDES	EXTRUDE
EXUDES	EXUDE
EXULTS	EXULT
EY	EY
EYES	EYE
EYEBALLING	EYEBAL
EYEBALL	EYEBALL
FING	F
FA	FA
FABLIAUX	FABLIAUX
FABRICATES	FABRICATE
FAC	FAC
FACES	FACE
FACETED	FACETE
FACIE	FACIE
FACILITATES	FACILITATE
FACTO	FACTO
FACTORS	FACTOR
FACTORED	FACTORE
FACTORISES	FACTORISE
FACTORTAME	FACTORTAME
FADES	FADE
FAFF	FAFF
FAGGED	FAG
FAGG	FAGG
FAHRENHEIT	FAHRENHEIT
FAI	FAI
FAILS	FAIL
F�IL	F�IL
FAINTS	FAINT
FAIRED	FAIR
FAIRE	FAIRE
FAIT	FAIT
FAJR	FAJR
FAKES	FAKE
FALLS	FALL
FALSIFIES	FALSIFY
FALSTAFF	FALSTAFF
FALTERS	FALTER
FAM	FAM
FAMILIARISES	FAMILIARISE
FAMILIARIZED	FAMILIARIZE
FAMILLE	FAMILLE
FANS	FAN
FANCIES	FANCY
FANTASISES	FANTASISE
FANTASIZED	FANTASIZE
FAP	FAP
FAR	FAR
FARAH	FARAH
FARES	FARE
FAREWELL	FAREWELL
FARMS	FARM
FARRAH	FARRAH
FARROWING	FARROW
FARTS	FART
FAS	FAS
FASCINATES	FASCINATE
FASH	FASH
FASHIONS	FASHION
FASTS	FAST
FASTENS	FASTEN
FATTEST	FAT
FATAH	FATAH
FATALE	FATALE
FATALES	FATALES
FATED	FATE
FATH	FATH
FATHERED	FATHER
FATHOM	FATHOM
FATIGUED	FATIGUE
FATTENS	FATTEN
FATTIER	FATTY
FAULTS	FAULT
FAUX	FAUX
FAV	FAV
FAVE	FAVE
FAVOR	FAVOR
FAVORED	FAVORE
FAVOURS	FAVOUR
FAWN	FAWN
FAXES	FAX
FAYED	FAY
FAZED	FAZE
FE	FE
FEARS	FEAR
FEASTED	FEAST
FEATHER	FEATHER
FEATURES	FEATURE
FEB	FEB
FEDERATES	FEDERATE
FEDERATION	FEDERATION
F�D�RATION	F�D�RATION
FEE	FEE
FEEBLEST	FEEBL
FEEDS	FEED
FEELS	FEEL
FEF	FEF
FEGET	FEGET
FEIGNS	FEIGN
FEIN	FEIN
F�IN	F�IN
FEINTING	FEINT
FEL	FEL
FELLED	FELL
FELTED	FELT
FEMME	FEMME
FEMMES	FEMMES
FENCED	FENCE
FENDS	FEND
FER	FER
FERMENTS	FERMENT
FEROX	FEROX
FERRET	FERRET
FERRETED	FERRETE
FERRIED	FERRY
FERTILISES	FERTILISE
FERTILIZES	FERTILIZE
FESTERING	FESTER
FESTOONED	FESTOON
FETCHES	FETCH
FETED	FETE
F�TED	F�TED
FETTERED	FETTER
FEUDING	FEUD
FEVERED	FEVER
FFEATHERSTONEHAUGH	FFEATHERSTONEHAUGH
FI	FI
FIBROBLASTS	FIBROBLAST
FIDDLES	FIDDLE
FIDES	FIDE
FIDES	FIDES
FIDGETS	FIDGET
FIDGETING	FIDGETE
FIE	FIE
FIELDS	FIELD
FIERCEST	FIERCE
FIF	FIF
FIFTEEN	FIFTEEN
FIFTEENTH	FIFTEENTH
FIFTEENTHS	FIFTEENTHS
FIFTH	FIFTH
FIFTHS	FIFTHS
FIFTIES	FIFTIES
FIFTIETH	FIFTIETH
FIFTY	FIFTY
FIG	FIG
FIGARO	FIGARO
FIGHTS	FIGHT
FIGURES	FIGURE
FIL	FIL
FILCHED	FILCH
FILES	FILE
FILIBUSTERING	FILIBUSTER
FILLS	FILL
FILLE	FILLE
FILLET	FILLET
FILLETED	FILLETE
FILMS	FILM
FILMMAKING	FILMMAKE
FILTERS	FILTER
FILTHIEST	FILTHY
FIN	FIN
FINALISES	FINALISE
FINALIZED	FINALIZE
FINANCES	FINANCE
FINANCI�RE	FINANCI�RE
FINDS	FIND
FINES	FINE
FINGERS	FINGER
FINGERPRINTED	FINGERPRINT
FINGERSPELLING	FINGERSPEL
FINGERTIP	FINGERTIP
FINISHES	FINISH
FINKS	FINK
FINLAY	FINLAY
FINNISH	FINNISH
FINTA	FINTA
FIR	FIR
FIRES	FIRE
FIREBOMBED	FIREBOMB
FIREFIGHTING	FIREFIGHT
FIRMED	FIRM
FIRMA	FIRMA
FIRS	FIRS
FIRST	FIRST
FISHES	FISH
FIST	FIST
FITS	FIT
FITCH	FITCH
FIVE	FIVE
FIVES	FIVES
FIXES	FIX
FIXATED	FIXATE
FIZZING	FIZ
FIZZ	FIZZ
FIZZLES	FIZZLE
FJORTOFT	FJORTOFT
FL	FL
FLA	FLA
FLAB	FLAB
FLAGS	FLAG
FLAGELLATING	FLAGELLATE
FLAGRANTE	FLAGRANTE
FLAILS	FLAIL
FLAKES	FLAKE
FLAMED	FLAME
FLANKED	FLANK
FLAPS	FLAP
FLARES	FLARE
FLASHES	FLASH
FLASHIEST	FLASHY
FLAT	FLAT
FLATTENS	FLATTEN
FLATTERS	FLATTER
FLAUNTS	FLAUNT
FLAVOURED	FLAVOUR
FLAYED	FLAY
FLECKED	FLECK
FLEDERMAUS	FLEDERMAUS
FLEDGED	FLEDGE
FLEES	FLEE
FLEECES	FLEECE
FLEETING	FLEET
FLESHED	FLESH
FLEUR	FLEUR
FLEURS	FLEURS
FLEXES	FLEX
FLIC	FLIC
FLICKS	FLICK
FLICKERS	FLICKER
FLIGHTED	FLIGHT
FLIMSIEST	FLIMSY
FLINCHES	FLINCH
FLINGS	FLING
FLIPS	FLIP
FLIRTS	FLIRT
FLITS	FLIT
FLITTERED	FLITTER
FLITTERN	FLITTERN
FLO	FLO
FLOATS	FLOAT
FLOCKED	FLOCK
FLOGS	FLOG
FLOODS	FLOOD
FLOODLIGHTING	FLOODLIGHT
FLOODWATER	FLOODWATE
FLOORED	FLOOR
FLOORCOVERING	FLOORCOVER
FLOPS	FLOP
FLOPPIER	FLOPPY
FLORES	FLORES
FLORIDA	FLORIDA
FLOSSING	FLOSS
FLOUNCES	FLOUNCE
FLOUNDERED	FLOUNDER
FLOURING	FLOUR
FLOURISHES	FLOURISH
FLOUTS	FLOUT
FLOWS	FLOW
FLOWERS	FLOWER
FLUCTUATES	FLUCTUATE
FLUFFS	FLUFF
FLUKED	FLUKE
FLUNKED	FLUNK
FLUORESCES	FLUORESCE
FLUORIDE	FLUORIDE
FLURRIED	FLURRY
FLUSHES	FLUSH
FLUSTERED	FLUSTER
FLUTED	FLUTE
FLUTTERS	FLUTTER
FLIES	FLY
FLYPAST	FLYPAST
FLYSHEET	FLYSHEET
FM	FM
FO	FO
FOALED	FOAL
FOAM	FOAM
FOBBED	FOB
FOCUSES	FOCUS
FOCUSSES	FOCUSSES
FOETUSES	FOETUSE
FOGGED	FOG
FOGGIEST	FOGGY
FOIE	FOIE
FOILS	FOIL
FOISTED	FOIST
FOLDS	FOLD
FOLIE	FOLIE
FOLLOWS	FOLLOW
FOLLOWING	FOLLOWING
FOMENTED	FOMENT
FONDEST	FOND
FONDLES	FONDLE
FOO	FOO
FOOLS	FOOL
FOOLPROOF	FOOLPROOF
FOOTS	FOOT
FOOTNOTE	FOOTNOTE
FOOTPRINTS	FOOTPRINT
FOR	FOR
FORAGES	FORAGE
FORBAD	FORBAD
FORBEAR	FORBEAR
FORBIDS	FORBID
FORBORE	FORBORE
FORCES	FORCE
FORCEPS	FORCEP
FORD	FORD
FORDYCE	FORDYCE
FORE	FORE
FORECASTS	FORECAST
FORECLOSES	FORECLOSE
FOREFINGER	FOREFING
FOREGATHER	FOREGATHER
FOREGONE	FOREGO
FOREGROUNDED	FOREGROUND
FOREMOST	FOREMOST
FORESEES	FORESEE
FORESHADOWS	FORESHADOW
FORESHORTENED	FORESHORTEN
FORESTALLED	FORESTAL
FORESTALL	FORESTALL
FORETELLS	FORETELL
FORETOLD	FORETOLD
FOREWARNS	FOREWARN
FORFEITS	FORFEIT
FORFEITURE	FORFEITURE
FORGES	FORGE
FORGETS	FORGET
FORGIVES	FORGIVE
FORGO	FORGO
FORGONE	FORGONE
FORKS	FORK
FORMS	FORM
FORMA	FORMA
FORMALISES	FORMALISE
FORMALIZES	FORMALIZE
FORMATTED	FORMAT
FORME	FORME
FORMER	FORMER
FORMULATES	FORMULATE
FORNICATE	FORNICATE
FORSAKES	FORSAKE
FORSOOK	FORSOOK
FORSWEAR	FORSWEAR
FORT	FORT
FORTIES	FORTIES
FORTIETH	FORTIETH
FORTIFIED	FORTIFY
FORTIORI	FORTIORI
FORTIS	FORTIS
FORTY	FORTY
FORWARDS	FORWARD
FOSSE	FOSSE
FOSSILISED	FOSSILISE
FOSSILIZE	FOSSILIZE
FOSTERS	FOSTER
FOU	FOU
FOUCAULT	FOUCAULT
FOULS	FOUL
FOUNDS	FOUND
FOUNDERED	FOUNDER
FOUNTAINED	FOUNTAIN
FOUR	FOUR
FOURS	FOURS
FOURTEEN	FOURTEEN
FOURTEENTH	FOURTEENTH
FOURTH	FOURTH
FOUTRE	FOUTRE
FOXED	FOX
FR	FR
FRA	FRA
FRACTIONATED	FRACTIONATE
FRACTURED	FRACTURE
FRAG	FRAG
FRAGMENTS	FRAGMENT
FRA�CHE	FRA�CHE
FRAILEST	FRAIL
FRAIS	FRAIS
FRAMES	FRAME
FRANCA	FRANCA
FRANCAIS	FRANCAIS
FRAN�AIS	FRAN�AIS
FRANCAISE	FRANCAISE
FRAN�AISE	FRAN�AISE
FRANCE	FRANCE
FRANCHISED	FRANCHISE
FRANKED	FRANK
FRANTISEK	FRANTISEK
FRATERNISE	FRATERNISE
FRATERNIZE	FRATERNIZE
FRAU	FRAU
FRAYS	FRAY
FRAZZLING	FRAZZLE
FRE	FRE
FREAKS	FREAK
FRECKLED	FRECKLE
FREES	FREE
FREELANCED	FREELANCE
FREEMANTLE	FREEMANTLE
FREEPHONE	FREEPHONE
FREESTANDING	FREESTAND
FREEWHEELING	FREEWHEEL
FREEZES	FREEZE
FREIE	FREIE
FREIGHTED	FREIGHT
FRENCHAY	FRENCHAY
FRENZIED	FRENZY
FREQUENTS	FREQUENT
FRESCO	FRESCO
FRESHEST	FRESH
FRESHENED	FRESHEN
FRETS	FRET
FRI	FRI
FRIBBLE	FRIBBLE
FRIENDLIEST	FRIENDLY
FRIGATES	FRIGATE
FRIGHTENS	FRIGHTEN
FRINGED	FRINGE
FRISKS	FRISK
FRITTERED	FRITTER
FRITZ	FRITZ
FRO	FRO
FROBISHER	FROBISH
FROGMARCHED	FROGMARCH
FROLIC	FROLIC
FROLICKING	FROLICK
FROM	FROM
FROMAGE	FROMAGE
FRONTS	FRONT
FRONTERA	FRONTERA
FRONTI�RES	FRONTI�RES
FROSTING	FROST
FROTH	FROTH
FROWNS	FROWN
FRUD	FRUD
FRUITING	FRUIT
FRUITBAT	FRUITBAT
FRUITIEST	FRUITY
FRUSTRATES	FRUSTRATE
FRIED	FRY
FRYE	FRYE
FS	FS
FU	FU
FUCKS	FUCK
FUDGED	FUDGE
FUELS	FUEL
FULFILS	FULFIL
FULFILLS	FULFILL
FULK	FULK
FULLING	FULL
FULMINATE	FULMINATE
FUMBLES	FUMBLE
FUMES	FUME
FUMIGATED	FUMIGATE
FUN	FUN
FUNCTIONS	FUNCTION
FUNDS	FUND
FUNDHOLDING	FUNDHOLD
FUNDRAISING	FUNDRAISE
FUNK	FUNK
FUNKIER	FUNKY
FUNNELLED	FUNNEL
FUNNIEST	FUNNY
FURRED	FUR
F�R	F�R
FURLED	FURL
FURNISHES	FURNISH
FURROWED	FURROW
FURRIER	FURRY
FURTHERS	FURTHER
FUSES	FUSE
FUSELAGE	FUSELAGE
FUSSES	FUSS
FUT	FUT
FUW	FUW
FYNED	FYN
G	G
GA	GA
GABBING	GAB
GABBLE	GABBLE
GADDING	GAD
GAGS	GAG
GAINS	GAIN
GAINSAID	GAINSAY
GAL	GAL
GALERIE	GALERIE
GALLED	GALL
GALLIVANTING	GALLIVANT
GALLO	GALLO
GALLOPS	GALLOP
GALVANISES	GALVANISE
GALVANIZED	GALVANIZE
GAMBLES	GAMBLE
GAMBOLLING	GAMBOL
GAMES	GAME
GANDALF	GANDALF
GANGED	GANG
GAOLED	GAOL
GAPES	GAPE
GAR	GAR
GARAGED	GARAGE
GARBED	GARB
GARDE	GARDE
GARD�E	GARD�E
GARDENED	GARDEN
GARE	GARE
GARGLE	GARGLE
GARLANDED	GARLAND
GARNERED	GARNER
GARNI	GARNI
GARNISHED	GARNISH
GARRET	GARRET
GARRISONED	GARRISON
GARROTTED	GARROT
GARRY	GARRY
GAS	GAS
GASHED	GASH
GASPS	GASP
GASSED	GASS
GASTHAUS	GASTHAUS
GASTHOF	GASTHOF
GATED	GATE
GATECRASHED	GATECRASH
GATEPOSTS	GATEPOST
GATHERS	GATHER
GAUCHE	GAUCHE
GAUGED	GAUGE
GAVRIIL	GAVRIIL
GAWK	GAWK
GAWPED	GAWP
GAYEST	GAYE
GAZES	GAZE
GAZETTED	GAZETTE
GED	GE
GEARS	GEAR
GEDGE	GEDGE
GEE	GEE
GEES	GEES
GEL	GEL
GELD	GELD
GELLED	GELL
GEMMELL	GEMMELL
GENNED	GEN
GENDERED	GENDER
GENERAL	GENERAL
G�N�RALE	G�N�RALE
GENERALISES	GENERALISE
GENERALIZES	GENERALIZE
GENERATES	GENERATE
GENERIS	GENERIS
GENESTEALER	GENESTEAL
GENEVIEVE	GENEVIEVE
GENTILHOMME	GENTILHOMME
GENTLEST	GENTL
GENTLED	GENTLE
GENUFLECT	GENUFLECT
GEO	GEO
GEORG	GEORG
GER	GER
GERAINT	GERAINT
GERMS	GERM
GERMAINE	GERMAINE
GERMANISED	GERMANISE
GERMINATES	GERMINATE
GERONIMO	GERONIMO
GERRIT	GERRIT
GERRYMANDERING	GERRYMANDER
GERT	GERT
GESCHICHTE	GESCHICHTE
GESELLSCHAFT	GESELLSCHAFT
GESTICULATE	GESTICULATE
GESTURES	GESTURE
GETS	GET
GHORBANIFAR	GHORBANIFAR
GHOSTING	GHOST
GHOUL	GHOUL
GI	GI
GIBBER	GIBBER
GIBED	GIBE
GIDDING	GID
GIES	GIE
GIFTED	GIFT
GIGGED	GIG
GIGGS	GIGG
GIGGLES	GIGGLE
GIGOT	GIGOT
GIL	GIL
GILDED	GILD
GILLING	GILL
GILLICK	GILLICK
GILMOUR	GILMOUR
GIM	GIM
GIMMER	GIMMER
GIMMICKS	GIMMICK
GIORNALE	GIORNALE
GIR	GIR
GIRDS	GIRD
GIRDLED	GIRDLE
GIVETH	GIVE
GL	GL
GLA	GLA
GLACE	GLACE
GLACIATED	GLACIATE
GLADDER	GLAD
GLADDENS	GLADDEN
GLAMORISE	GLAMORISE
GLAMORIZE	GLAMORIZE
GLANCES	GLANCE
GLARES	GLARE
GLASGAY	GLASGAY
GLASSED	GLASS
GLAZED	GLAZE
GLAZIER	GLAZY
GLEAMS	GLEAM
GLEANED	GLEAN
GLENCOE	GLENCOE
GLICK	GLICK
GLIDES	GLIDE
GLIDEWELL	GLIDEWELL
GLIMMER	GLIMMER
GLIMPSES	GLIMPSE
GLINT	GLINT
GLISTENS	GLISTEN
GLITTER	GLITTER
GLOATS	GLOAT
GLOOMED	GLOOM
GLOOMIEST	GLOOMY
GLORIA	GLORIA
GLORIFIES	GLORIFY
GLORIES	GLORY
GLOSSES	GLOSS
GLOSSIEST	GLOSSY
GLOWS	GLOW
GLOWERING	GLOWER
GLUES	GLUE
GLUG	GLUG
GLYNN	GLYNN
GNASHES	GNASH
GNAWS	GNAW
GOS	GO
GOADED	GOAD
GOAT	GOAT
GOBBING	GOB
GOBBLES	GOBBLE
GOBSMACKED	GOBSMACK
GODDAMN	GODDAMN
GOERING	GOER
GOGGLES	GOGGLE
GOI	GOI
GOIN	GOIN
GOLDING	GOLD
GOLLY	GOLLY
GON	GON
GONDOLIER	GONDOLY
GOO	GOO
BEST	GOOD
GOODBYE	GOODBYE
GOODNIGHT	GOODNIGHT
GOOFED	GOOF
GOOGOL	GOOGOL
GOOSED	GOOSE
GOR	GOR
GORED	GORE
GORGED	GORGE
G�RING	G�RING
GORIER	GORY
GOSH	GOSH
GOSHAWK	GOSHAWK
GOSS	GOSS
GOSSIPS	GOSSIP
GOSSIPED	GOSSIPE
GOT	GOT
GOTCHA	GOTCHA
GOTT	GOTT
GOUGED	GOUGE
GOULED	GOUL
GOULDING	GOULD
GOVERNS	GOVERN
GR	GR
GRA	GRA
GRABS	GRAB
GRACES	GRACE
GR�CE	GR�CE
GRACIAS	GRACIAS
GRADED	GRADE
GRADUATES	GRADUATE
GRAF	GRAF
GRAFTED	GRAFT
GRAINED	GRAIN
GRAMMATICALIZED	GRAMMATICALIZE
GRAN	GRAN
GRAND	GRAND
GRANDE	GRANDE
GRANDEUR	GRANDEUR
GRANDIFLORA	GRANDIFLORA
GRANDIS	GRANDIS
GRANDS	GRANDS
GRANTS	GRANT
GRANULATED	GRANULATE
GRAPHING	GRAPH
GRAPPLES	GRAPPLE
GRAS	GRAS
GRASPS	GRASP
GRASSED	GRASS
GRATA	GRATA
GRATES	GRATE
GRATIA	GRATIA
GRATIFIES	GRATIFY
GRAVEST	GRAVE
GRAVITATES	GRAVITATE
GRAZES	GRAZE
GRAZIE	GRAZIE
GRE	GRE
GREA	GREA
GREASED	GREASE
GREASIEST	GREASY
GREATEST	GREAT
GREEDIEST	GREEDY
GREENED	GREEN
GREENBAUM	GREENBAUM
GREENCROFT	GREENCROFT
GREENIDGE	GREENIDGE
GREER	GREER
GREETS	GREET
GR�GOIRE	GR�GOIRE
GREIG	GREIG
GRETEL	GRETEL
GREYED	GREY
GREYER	GREYE
GREYHOUND	GREYHOUND
GRIDDED	GRID
GRIEVES	GRIEVE
GRILLED	GRILL
GRIMMEST	GRIM
GRIMACES	GRIMACE
GRIMED	GRIME
GRIMIER	GRIMY
GRINS	GRIN
GRINDS	GRIND
GRIPS	GRIP
GRIPES	GRIPE
GRIS	GRIS
GRISE	GRISE
GRISLIEST	GRISLY
GRITS	GRIT
GRITTIER	GRITTY
GRIZZLING	GRIZZLE
GRO	GRO
GROANS	GROAN
GROATS	GROAT
GROBBELAAR	GROBBELAAR
GROM	GROM
GROOMS	GROOM
GROOVED	GROOVE
GROOVERS	GROOVER
GROPES	GROPE
GROSSED	GROSS
GROSSE	GROSSE
GROUNDS	GROUND
GROUNDSHEET	GROUNDSHEET
GROUPS	GROUP
GROUTED	GROUT
GROVEL	GROVEL
GROWS	GROW
GROWLS	GROWL
GROWN	GROWN
GRRR	GRRR
GRUBBED	GRUB
GRUBBIER	GRUBBY
GRUDGED	GRUDGE
GRUMBLES	GRUMBLE
GRUMPED	GRUMP
GRUMPIER	GRUMPY
GRUNDIG	GRUNDIG
GRUNTS	GRUNT
GU	GU
GUARANTEES	GUARANTEE
GUARDS	GUARD
GUERRE	GUERRE
GUESSES	GUESS
GUESTING	GUEST
GUFFAWING	GUFFAW
GUI	GUI
GUIDES	GUIDE
GUILDSOFT	GUILDSOFT
GUILLAUME	GUILLAUME
GUILLOTINED	GUILLOTINE
GULLED	GULL
GULPS	GULP
GUM	GUM
GUNNED	GUN
GUNDOVALD	GUNDOVALD
GUNG	GUNG
GUNTRAM	GUNTRAM
GURDER	GURDER
GURGLES	GURGLE
GUSHES	GUSH
GUSTING	GUST
GUSTAVE	GUSTAVE
GUTTED	GUT
GUTEN	GUTEN
GUTTERED	GUTTER
GUZZLES	GUZZLE
GWENDOLINE	GWENDOLINE
GYBING	GYB
GYBE	GYBE
GYPSOPHILA	GYPSOPHILA
GYRATE	GYRATE
HED	H
HA	HA
HABEAS	HABEAS
HABIB	HABIB
HABITUATED	HABITUATE
HACKS	HACK
HAD	HAD
HAEMORRHAGING	HAEMORRHAGE
HAF	HAF
HAFF	HAFF
HAGGADAH	HAGGADAH
HAGGLED	HAGGLE
HAH	HAH
HAIDER	HAIDER
HAILS	HAIL
HAIM	HAIM
HAIMET	HAIMET
HAIRIER	HAIRY
HAKIM	HAKIM
HALED	HALE
HALIBORANGE	HALIBORANGE
HALIL	HALIL
HALLING	HALL
HALLELUJA	HALLELUJA
HALLELUJAH	HALLELUJAH
HALLMARKED	HALLMARK
HALLO	HALLO
HALLUCINATED	HALLUCINATE
HALOED	HALO
HALTS	HALT
HALVES	HALVE
HAMMING	HAM
HAMMERS	HAMMER
HAMPERS	HAMPER
HAMSTRUNG	HAMSTRUNG
HANNING	HAN
HANDS	HAND
HANDCRAFTED	HANDCRAFT
HANDCUFFED	HANDCUFF
HANDICAPPED	HANDICAP
HANDLES	HANDLE
HANDPAINTED	HANDPAINT
HANDPICKED	HANDPICK
HANDSOMEST	HANDSOME
HANDWASHING	HANDWASH
HANDWRITTEN	HANDWRITTEN
HANDIER	HANDY
HANGS	HANG
HANKER	HANK
HANKERED	HANKER
HANNS	HANN
HAP	HAP
HAPPENS	HAPPEN
HAPPIEST	HAPPY
HAR	HAR
HARANGUED	HARANGUE
HARASSES	HARASS
HARBOURS	HARBOUR
HARD	HARD
HARDCORE	HARDCORE
HARDENS	HARDEN
HARDIEST	HARDY
HARING	HARE
HARKS	HARK
HARMS	HARM
HARMONIE	HARMONIE
HARMONISES	HARMONISE
HARMONIZES	HARMONIZE
HARNESSES	HARNESS
HARPS	HARP
HARPOONED	HARPOON
HARROWED	HARROW
HARRIED	HARRY
HARSHEST	HARSH
HARTNOLL	HARTNOLL
HARVESTS	HARVEST
HAS	HAS
HASHING	HASH
HASSLED	HASSLE
HASTED	HAST
HASTE	HASTE
HASTENS	HASTEN
HATTED	HAT
HATCHES	HATCH
HATES	HATE
HATH	HATH
HAUE	HAUE
HAULS	HAUL
HAULIER	HAULY
HAUNTS	HAUNT
HAUTBOIS	HAUTBOIS
HAUTE	HAUTE
HAV	HAV
HAS	HAVE
HAVEN	HAVEN
HAWED	HAW
HAWKED	HAWK
HAY	HAY
HAYEK	HAYEK
HAYTIMING	HAYTIME
HAZARD	HAZARD
HAZED	HAZE
HAZLITT	HAZLITT
HAZIEST	HAZY
HBSAG	HBSAG
HE	HE
HEA	HEA
HEADS	HEAD
HEADACHES	HEADACH
HEADBUTTING	HEADBUT
HEADHUNTED	HEADHUNT
HEADLINED	HEADLINE
HEADQUARTERED	HEADQUARTER
HEADREST	HEADR
HEADIER	HEADY
HEALS	HEAL
HEALTHIEST	HEALTHY
HEAPED	HEAP
HEARS	HEAR
HEARKEN	HEARKEN
HEARTBEAT	HEARTBEAT
HEARTENED	HEARTEN
HEARTIEST	HEARTY
HEATS	HEAT
HEATHCLIFF	HEATHCLIFF
HEAVES	HEAVE
HEAVIEST	HEAVY
HEBE	HEBE
HECKLED	HECKLE
HECTOR	HECTOR
HECTORING	HECTORE
HEDERA	HEDERA
HEDGES	HEDGE
HEE	HEE
HEEDS	HEED
HEELED	HEEL
HEFTING	HEFT
HEFTIER	HEFTY
HEH	HEH
HEIFERS	HEIFER
HEIGHTENS	HEIGHTEN
HEIL	HEIL
HEINRICH	HEINRICH
HEL	HEL
HELICES	HELICE
HELICOPTERED	HELICOPTER
HELLEBORUS	HELLEBORUS
HELLO	HELLO
HELMING	HELM
H�LOISE	H�LOISE
HELPS	HELP
HEMMED	HEM
HENRYK	HENRYK
HEPZIBAH	HEPZIBAH
HER	HER
HERALDS	HERALD
HERBES	HERBES
HERCULE	HERCULE
HERDED	HERD
HERE	HERE
HERMIONE	HERMIONE
HERREN	HERREN
HERRI	HERRI
HERRIOT	HERRIOT
HERS	HERS
HERSELF	HERSELF
HESITATES	HESITATE
HESS	HESS
HET	HET
HEURE	HEURE
HEV	HEV
HEW	HEW
HEWLETT	HEWLETT
HEY	HEY
HG	HG
HI	HI
HIBERNATED	HIBERNATE
HIC	HIC
HICCUP	HICCUP
HICCUPING	HICCUPE
HIDES	HIDE
HIE	HIE
HIGH	HIGH
HIGHGROVE	HIGHGROVE
HIGHLIGHTS	HIGHLIGHT
HIJACKED	HIJACK
HIKED	HIKE
HILBORNE	HILBORNE
HILLWALKING	HILLWALK
HILLIEST	HILLY
HIMSELF	HIMSELF
HIN	HIN
HINDERS	HINDER
HINGING	HING
HINGES	HINGE
HINRICH	HINRICH
HINTS	HINT
HIPPEST	HIP
HIRAM	HIRAM
HIRES	HIRE
HIRSELF	HIRSELF
HIS	HIS
HISSES	HISS
HISSELF	HISSELF
HISTAMINE	HISTAMINE
HISTOIRE	HISTOIRE
HISTORIA	HISTORIA
HISTORIARUM	HISTORIARUM
HITS	HIT
HITCHES	HITCH
HITCHHIKING	HITCHHIKE
HIVED	HIVE
HIYA	HIYA
HM	HM
HMM	HMM
HO	HO
HOARDED	HOARD
HOARSER	HOARSE
HOBBLES	HOBBLE
HOBNOBBING	HOBNOB
HOC	HOC
HOCKING	HOCK
HODDLE	HODDLE
HOED	HOE
HOFF	HOFF
HOGS	HOG
HOGG	HOGG
HOI	HOI
HOISTS	HOIST
HOLS	HOL
HOLA	HOLA
HOLCUS	HOLCUS
HOLDS	HOLD
HOLED	HOLE
HOLIDAYS	HOLIDAY
HOLLERS	HOLLER
HOLLOWED	HOLLOW
HOLSTERED	HOLSTER
HOLIEST	HOLY
HOMES	HOME
HOMELIER	HOMELY
HOMESTEADING	HOMESTEAD
HOMEWORKING	HOMEWORK
HOMINES	HOMINE
HOMINEM	HOMINEM
HOMME	HOMME
HOMMES	HOMMES
HOMO	HOMO
HOMOGENISED	HOMOGENISE
HOMOGENIZED	HOMOGENIZE
HONING	HON
HONES	HONE
HONEYCOMBED	HONEYCOMB
HONEYMOON	HONEYMOON
HONK	HONK
HONOR	HONOR
HONOR�	HONOR�
HONOURS	HONOUR
HOO	HOO
HOODING	HOOD
HOODWINKED	HOODWINK
HOOF	HOOF
HOOKS	HOOK
HOOPED	HOOP
HOORAY	HOORAY
HOOTS	HOOT
HOOVERS	HOOVER
HOPPED	HOP
HOPES	HOPE
HOPSCOTCH	HOPSCOTCH
HOR	HOR
HORNED	HORN
HORNIEST	HORNY
HOROWITZ	HOROWITZ
HORRIBILIS	HORRIBILIS
HORRIFIES	HORRIFY
HORROCKS	HORROCK
HORS	HORS
HORSING	HORSE
HORSERACING	HORSERACE
HORSETAILS	HORSETAIL
HORTICULTURE	HORTICULTURE
HOSES	HOSE
HOSPITALISED	HOSPITALISE
HOSPITALIZED	HOSPITALIZE
HOSTS	HOST
HOTTING	HOT
H�TEL	H�TEL
HOTFOOTING	HOTFOOT
HOU	HOU
HOUGH	HOUGH
HOUNDED	HOUND
HOUS	HOUS
HOUSES	HOUSE
HOUSEBREAKING	HOUSEBREAK
HOUSEBUILDING	HOUSEBUILD
HOVES	HOVE
HOVERS	HOVER
HOW	HOW
HOWEVER	HOWEVER
HOWLS	HOWL
HOY	HOY
HRUN	HRUN
HS	HS
HU	HU
HUANG	HUANG
HUDDLES	HUDDLE
HUFFED	HUFF
HUGS	HUG
HUGER	HUGE
HUH	HUH
HULLED	HULL
HULLO	HULLO
HUMS	HUM
HUMANIORES	HUMANIORE
HUMANISES	HUMANISE
HUMANIZE	HUMANIZE
HUMANKIND	HUMANKIND
HUMBLEST	HUMBL
HUMBLES	HUMBLE
HUMBUGGED	HUMBUG
HUME	HUME
HUMILIATES	HUMILIATE
HUMOURED	HUMOUR
HUMPS	HUMP
HUN	HUN
HUNCHED	HUNCH
HUND	HUND
HUNDRED	HUNDRED
HUNDREDS	HUNDREDS
HUNDREDTH	HUNDREDTH
HUNDREDTHS	HUNDREDTHS
HUNGERED	HUNGER
HUNGRIEST	HUNGRY
HUNKS	HUNK
HUNKERING	HUNKER
HUNTS	HUNT
HUP	HUP
HURDLE	HURDLE
HURLS	HURL
HURRAH	HURRAH
HURRAY	HURRAY
HURRIES	HURRY
HURTS	HURT
HURTLES	HURTLE
HUSBANDED	HUSBAND
HUSHED	HUSH
HUSKED	HUSK
HUSKIER	HUSKY
HUSSAIN	HUSSAIN
HUSTLED	HUSTLE
HUV	HUV
HUW	HUW
HWIM	HWIM
HYATT	HYATT
HYBRIDISES	HYBRIDISE
HYBRIDIZES	HYBRIDIZE
HYDRATED	HYDRATE
HYDROLYSED	HYDROLYSE
HYMNED	HYMN
HYPED	HYP
HYPE	HYPE
HYPERDESK	HYPERDESK
HYPERVENTILATE	HYPERVENTILATE
HYPNOTISES	HYPNOTISE
HYPNOTIZED	HYPNOTIZE
HYPOTHESI	HYPOTHESI
HYPOTHESISES	HYPOTHESISE
HYPOTHESIZES	HYPOTHESIZE
I	I
IA	IA
IANTHE	IANTHE
IAP	IAP
IBS	IB
ICE	ICE
ICF	ICF
ICH	ICH
ICN	ICN
ICIER	ICY
ID	ID
IDE	IDE
IDEALISING	IDEALISE
IDEALIZES	IDEALIZE
IDEM	IDEM
IDENTIFIES	IDENTIFY
IDG	IDG
IDLED	IDLE
IDOLISES	IDOLISE
IDOLIZED	IDOLIZE
IE	IE
IF	IF
IFF	IFF
IFN	IFN
IGG	IGG
IGNITES	IGNITE
IGNORES	IGNORE
II	II
IIB	IIB
IYING	IIE
III	III
IIIS	IIIS
IIS	IIS
IK	IK
ILS	IL
ILEX	ILEX
ILL	ILL
ILLUMINATES	ILLUMINATE
ILLUMINES	ILLUMINE
ILLUS	ILLUS
ILLUSTRATES	ILLUSTRATE
ILP	ILP
ILR	ILR
IM	IM
IMAGED	IMAGE
IMAGINES	IMAGINE
IMAX	IMAX
IMBALANCED	IMBALANCE
IMBEDDED	IMBED
IMBIBED	IMBIBE
IMBRICATED	IMBRICATE
IMBUES	IMBUE
IMITATES	IMITATE
IMMEDIATELY	IMMEDIATELY
IMMERSED	IMMERSE
IMMOBILISES	IMMOBILISE
IMMOBILIZED	IMMOBILIZE
IMMODERATE	IMMODERATE
IMMORTALISED	IMMORTALISE
IMMORTALIZED	IMMORTALIZE
IMMUNISED	IMMUNISE
IMMUNIZED	IMMUNIZE
IMMUNOBLOTTING	IMMUNOBLOT
IMMUNOPRECIPITATED	IMMUNOPRECIPITATE
IMMUNOSTAINED	IMMUNOSTAIN
IMMURED	IMMURE
IMP	IMP
IMPACTS	IMPACT
IMPAIRS	IMPAIR
IMPALED	IMPALE
IMPARTS	IMPART
IMPEACHED	IMPEACH
IMPEDES	IMPEDE
IMPELS	IMPEL
IMPERILLED	IMPERIL
IMPERSONATES	IMPERSONATE
IMPINGING	IMPING
IMPINGES	IMPINGE
IMPLANTS	IMPLANT
IMPLEMENTS	IMPLEMENT
IMPLICATES	IMPLICATE
IMPLODED	IMPLODE
IMPLORES	IMPLORE
IMPLIES	IMPLY
IMPORTS	IMPORT
IMPORTUNED	IMPORTUNE
IMPOSES	IMPOSE
IMPOUNDED	IMPOUND
IMPOVERISHES	IMPOVERISH
IMPREGNATED	IMPREGNATE
IMPRESSES	IMPRESS
IMPRINTED	IMPRINT
IMPRISONS	IMPRISON
IMPROVES	IMPROVE
IMPROVISED	IMPROVISE
IMPUGNED	IMPUGN
IMPUTES	IMPUTE
IN	IN
INA	INA
INACTIVATES	INACTIVATE
INASMUCH	INASMUCH
INAUGURATES	INAUGURATE
INBETWEEN	INBETWEEN
INC	INC
INCAPACITATES	INCAPACITATE
INCARCERATED	INCARCERATE
INCARNATES	INCARNATE
INCENSED	INCENSE
INCHES	INCH
INCHOATE	INCHOATE
INCINERATED	INCINERATE
INCISED	INCISE
INCITED	INCIT
INCITES	INCITE
INCLINES	INCLINE
INCLUDES	INCLUDE
INCLUDING	INCLUDING
INCONVENIENCED	INCONVENIENCE
INCORPORATES	INCORPORATE
INCREASES	INCREASE
INCREMENTED	INCREMENT
INCRIMINATED	INCRIMINATE
INCUBATES	INCUBATE
INCULCATES	INCULCATE
INCURS	INCUR
IND	IND
INDEED	INDEED
INDEMNIFIES	INDEMNIFY
INDENTS	INDENT
IND�PENDANTS	IND�PENDANTS
INDEXED	INDEX
INDICATES	INDICATE
INDICTS	INDICT
INDIVIDUALISED	INDIVIDUALISE
INDIVIDUALIZE	INDIVIDUALIZE
INDIVIDUATES	INDIVIDUATE
INDOCTRINATED	INDOCTRINATE
INDUCES	INDUCE
INDUCTED	INDUCT
INDULGES	INDULGE
INDUSTRIALISE	INDUSTRIALISE
INDUSTRIALIZED	INDUSTRIALIZE
INDUSTRIE	INDUSTRIE
INDWELLS	INDWELL
INE	INE
INF	INF
INFACT	INFACT
INFANTE	INFANTE
INFECTS	INFECT
INFERS	INFER
INFERENCING	INFERENCE
INFESTS	INFEST
INFILLED	INFIL
INFILL	INFILL
INFILTRATES	INFILTRATE
INFINITUM	INFINITUM
INFLAMES	INFLAME
INFLATES	INFLATE
INFLECTS	INFLECT
INFLICTS	INFLICT
INFLUENCES	INFLUENCE
INFO	INFO
INFORMS	INFORM
INFORMATION	INFORMATION
INFORMATIONSSYSTEME	INFORMATIONSSYSTEME
INFRINGES	INFRINGE
INFURIATES	INFURIATE
INFUSES	INFUSE
ING	ING
INGE	INGE
INGESTED	INGEST
INGRAINED	INGRAIN
INGRAM	INGRAM
INGRATIATE	INGRATIATE
INGROW	INGROW
INHABITS	INHABIT
INHALES	INHALE
INHERING	INHER
INHERITS	INHERIT
INHIBITS	INHIBIT
INITIALLED	INITIAL
INITIALISES	INITIALISE
INITIALIZED	INITIALIZE
INITIATES	INITIATE
INITIO	INITIO
INJECTS	INJECT
INJURES	INJURE
INKED	INK
INLAYS	INLAY
INNERVATES	INNERVATE
INNOVATES	INNOVATE
INOCULATED	INOCULATE
INPUTTED	INPUT
INQUIRES	INQUIRE
INS	INS
INSCRIBES	INSCRIBE
INSECTICIDES	INSECTICIDE
INSEMINATED	INSEMINATE
INSERTS	INSERT
INSET	INSET
INSIDE	INSIDE
INSINUATED	INSINUATE
INSISTS	INSIST
INSOFAR	INSOFAR
INSPECTS	INSPECT
INSPIRES	INSPIRE
INSTAL	INSTAL
INSTALLS	INSTALL
INSTANCED	INSTANCE
INSTANTIATES	INSTANTIATE
INSTIGATED	INSTIGATE
INSTILS	INSTIL
INSTILL	INSTILL
INSTITUT	INSTITUT
INSTITUTED	INSTITUTE
INSTITUTIONALISED	INSTITUTIONALISE
INSTITUTIONALIZED	INSTITUTIONALIZE
INSTRUCTS	INSTRUCT
INSULATES	INSULATE
INSULTS	INSULT
INSURES	INSURE
INT	INT
INTEGRATES	INTEGRATE
INTENDS	INTEND
INTENSIFIES	INTENSIFY
INTERRED	INTER
INTERACTS	INTERACT
INTERBREED	INTERBREED
INTERCALATING	INTERCALATE
INTERCEDES	INTERCEDE
INTERCEPTS	INTERCEPT
INTERCHANGING	INTERCHANG
INTERCHANGED	INTERCHANGE
INTERCONNECTED	INTERCONNECT
INTERDIGITATING	INTERDIGITATE
INTERESTS	INTEREST
INTERFACES	INTERFACE
INTERFERES	INTERFERE
INTERGRAPH	INTERGRAPH
INTERJECTS	INTERJECT
INTERLACED	INTERLACE
INTERLEAVED	INTERLEAVE
INTERLINKED	INTERLINK
INTERLOCKED	INTERLOCK
INTERLUDIUM	INTERLUDIUM
INTERMARRY	INTERMARRY
INTERMEDIA	INTERMEDIA
INTERMEDIATE	INTERMEDIATE
INTERMESHED	INTERMESH
INTERMINGLED	INTERMINGLE
INTERMIXED	INTERMIX
INTERNED	INTERN
INTERNALISED	INTERNALISE
INTERNALIZES	INTERNALIZE
INTERNATIONALE	INTERNATIONALE
INTERNATIONALISED	INTERNATIONALISE
INTERNATIONALIZED	INTERNATIONALIZE
INTERNETWORKING	INTERNETWORK
INTEROPERATE	INTEROPERATE
INTERPENETRATES	INTERPENETRATE
INTERPOLATED	INTERPOLATE
INTERPOSES	INTERPOSE
INTERPRETS	INTERPRET
INTERRELATED	INTERRELATE
INTERROGATES	INTERROGATE
INTERRUPTS	INTERRUPT
INTERSECTS	INTERSECT
INTERSPERSED	INTERSPERSE
INTERTWINED	INTERTWINE
INTERVENES	INTERVENE
INTERVIEWS	INTERVIEW
INTERWEAVES	INTERWEAVE
INTERWOVEN	INTERWOVEN
INTIMATES	INTIMATE
INTIMIDATES	INTIMIDATE
INTO	INTO
INTONING	INTON
INTONES	INTONE
INTOXICATED	INTOXICATE
INTRIGUED	INTRIGUE
INTRO	INTRO
INTRODUCES	INTRODUCE
INTROJECTED	INTROJECT
INTROVERTED	INTROVERT
INTRUDES	INTRUDE
INTUITED	INTUIT
INUNDATED	INUNDATE
INURED	INURE
INVADES	INVADE
INVALIDATES	INVALIDATE
INVALIDED	INVALIDE
INVEIGH	INVEIGH
INVEIGLED	INVEIGLE
INVENTS	INVENT
INVENTORIED	INVENTORY
INVERTS	INVERT
INVESTS	INVEST
INVESTIGATES	INVESTIGATE
INVIGORATES	INVIGORATE
INVITES	INVITE
INVOICED	INVOICE
INVOKES	INVOKE
INVOLVES	INVOLVE
IO	IO
IONISE	IONISE
IONIZED	IONIZE
IP	IP
IPSO	IPSO
IR	IR
IRI	IRI
IRKS	IRK
IRONED	IRON
IRRADIATED	IRRADIATE
IRRIGATED	IRRIGATE
IRRITATES	IRRITATE
IS	IS
ISAY	ISAY
ISBN	ISBN
ISDN	ISDN
ISH	ISH
ISM	ISM
ISN	ISN
ISOFORMS	ISOFORM
ISOLATES	ISOLATE
ISOLDE	ISOLDE
ISOMER	ISOME
ISS	ISS
ISSUES	ISSUE
IST	IST
IT	IT
ITALIA	ITALIA
ITALIAN	ITALIAN
ITALIANO	ITALIANO
ITALICISED	ITALICISE
ITALICIZED	ITALICIZE
ITCHES	ITCH
ITEMISES	ITEMISE
ITEMIZED	ITEMIZE
ITERATING	ITERATE
ITF	ITF
ITH	ITH
ITS	ITS
ITSELF	ITSELF
ITZHAK	ITZHAK
IV	IV
IVAN	IVAN
IVARS	IVAR
IVE	IVE
IX	IX
J	J
JA	JA
JABS	JAB
JABBERING	JABBER
JACKS	JACK
JACKPOT	JACKPOT
JADING	JADE
JADEROW	JADEROW
JAILED	JAIL
JAMMED	JAM
JAMMIEST	JAMMY
JAN	JAN
JANGLE	JANGLE
JANUSZ	JANUSZ
JAPONICA	JAPONICA
JAQ	JAQ
JARS	JAR
JAZZED	JAZ
JE	JE
JEERS	JEER
JEEVES	JEEVE
JEEZ	JEEZ
JELL	JELL
JEM	JEM
JENNER	JEN
JENKS	JENK
JEOPARDISES	JEOPARDISE
JEOPARDIZES	JEOPARDIZE
JERKS	JERK
JES	JES
JESTS	JEST
JESU	JESU
JET	JET
JETTISONED	JETTISON
JEU	JEU
JEUNE	JEUNE
JEUNESSE	JEUNESSE
JEUX	JEUX
JEWELLED	JEWEL
JI	JI
JIBBED	JIB
JIBE	JIBE
JIGGED	JIG
JIGGERED	JIGGER
JIGGLES	JIGGLE
JILTED	JILT
JINGLING	JINGLE
JINKING	JINK
JINXED	JINX
JIVE	JIVE
JO	JO
JOACHIM	JOACHIM
JOCK	JOCK
JOCKEY	JOCKEY
JOGS	JOG
JOGGLING	JOGGLE
JOHANN	JOHANN
JOHN	JOHN
JOHNSON	JOHNSON
JOIE	JOIE
JOINS	JOIN
JOINTED	JOINT
JOKES	JOKE
JOLLIES	JOLLY
JOLTS	JOLT
JONGLEUR	JONGLEUR
JOSEF	JOSEF
JOSEPH	JOSEPH
JOSHING	JOSH
JOSTLES	JOSTLE
JOTTED	JOT
JOUNCED	JOUNCE
JOURS	JOUR
JOURNAL	JOURNAL
JOURNEYED	JOURNEY
JOUSTING	JOUST
JOYRIDING	JOYRIDE
JOZEF	JOZEF
JOZSEF	JOZSEF
JTH	JTH
JU	JU
JUDDERS	JUDDER
JUDGES	JUDGE
JUDICE	JUDICE
JUGGLES	JUGGLE
JUICIEST	JUICY
JUKES	JUKE
JUL	JUL
JUMBLED	JUMBLE
JUMPS	JUMP
JUNG	JUNG
JUNKED	JUNK
JURE	JURE
JUS	JUS
JUST	JUST
JUSTE	JUSTE
JUSTIFIES	JUSTIFY
JUTS	JUT
JUXTAPOSES	JUXTAPOSE
K	K
KA	KA
KAIROS	KAIRO
KALMS	KALM
KAM	KAM
KAMPF	KAMPF
KANG	KANG
KAROL	KAROL
KARSTEN	KARSTEN
KARTING	KART
KAT	KAT
K�THE	K�THE
KAYSONE	KAYSONE
KE	KE
KEE	KEE
KEELS	KEEL
KEENING	KEEN
KEEPS	KEEP
KEIFER	KEIFER
KEN	KEN
KENNELLED	KENNEL
KEP	KEP
KERMIT	KERMIT
KERNING	KERN
KERNELS	KERNEL
KEYS	KEY
KEYBOARDED	KEYBOARD
KEYNES	KEYNE
KHOZRASCHET	KHOZRASCHET
KI	KI
KIAH	KIAH
KICKS	KICK
KICKSTART	KICKSTART
KIDDED	KID
KIDNAPS	KIDNAP
KIEFER	KIEFER
KILKENNY	KILKENNY
KILLS	KILL
KILNS	KILN
KILOBASES	KILOBASE
KIN	KIN
KIND	KIND
KINDER	KINDER
KINDLES	KINDLE
KINDLIER	KINDLY
KINKING	KINK
KIPPING	KIP
KIPPUR	KIPPUR
KIRGIZ	KIRGIZ
KIRSTEN	KIRSTEN
KISSES	KISS
KITTED	KIT
KLEINE	KLEINE
KLEINWORT	KLEINWORT
KN	KN
KNACKER	KNACKER
KNEADS	KNEAD
KNEEING	KNEE
KNEECAP	KNEECAP
KNEED	KNEED
KNEELS	KNEEL
KNIFED	KNIFE
KNIGHTED	KNIGHT
KNITS	KNIT
KNO	KNO
KNOBBED	KNOB
KNOCKS	KNOCK
KNOTTED	KNOT
KNOTTS	KNOTT
KNOTTIEST	KNOTTY
KNOWS	KNOW
KNOWES	KNOWE
KNOWN	KNOWN
KNUCKLES	KNUCKLE
KOBLENZ	KOBLENZ
KORG	KORG
KOWTOW	KOWTOW
KRING	KR
KRIEG	KRIEG
KS	KS
KUNG	KUNG
KUNST	KUNST
K�NSTE	K�NSTE
KIER	KY
KYAW	KYAW
KYRIE	KYRIE
L	L
LA	LA
LAB	LAB
LABELS	LABEL
LABELMATES	LABELMATE
LABERGE	LABERGE
LABOURS	LABOUR
LAC	LAC
LACES	LACE
LACERATED	LACERATE
LACKS	LACK
LACQUERED	LACQUER
LACTATING	LACTATE
LAD	LAD
LADDERED	LADDER
LADLES	LADLE
LAGS	LAG
LAISSEZ	LAISSEZ
LAIT	LAIT
LAMMING	LAM
LAMBASTED	LAMBAST
LAMES	LAME
LAMENTS	LAMENT
LAMINATED	LAMINATE
LAMPOONED	LAMPOON
LAN	LAN
LANCED	LANCE
LANDS	LAND
LANDHOLDING	LANDHOLD
LANDLOCKED	LANDLOCK
LANDSCAPED	LANDSCAPE
LANGUE	LANGUE
LANGUISHES	LANGUISH
LANHYDROCK	LANHYDROCK
LAPS	LAP
LAPSES	LAPSE
LAPWING	LAPW
LAR	LAR
LARDED	LARD
LARGEST	LARGE
LARK	LARK
LAS	LAS
LASCAUX	LASCAUX
LASERED	LASER
LASHES	LASH
LASSOING	LASSO
LASTS	LAST
LATCHES	LATCH
LATE	LATE
LATERALISED	LATERALISE
LATHERED	LATHER
LATTICED	LATTICE
LAUDS	LAUD
LAUDE	LAUDE
LAUGHS	LAUGH
LAUNCHES	LAUNCH
LAUNDERED	LAUNDER
LAVISHED	LAVISH
LAYS	LAY
LAYERED	LAYER
LAZ	LAZ
LAZAR	LAZAR
LAZE	LAZE
LAZIEST	LAZY
LE	LE
LEA	LEA
LEACHES	LEACH
LEADS	LEAD
LEAF	LEAF
LEAFLETING	LEAFLETE
LEAFIER	LEAFY
LEAH	LEAH
LEAKS	LEAK
LEANS	LEAN
LEAPS	LEAP
LEAPFROG	LEAPFROG
LEARNS	LEARN
LEASES	LEASE
LEAVES	LEAVE
LEAVENED	LEAVEN
LEBEN	LEBEN
LEC	LEC
LECTURES	LECTURE
LED	LED
LEECHING	LEECH
LEEDS	LEED
LEERS	LEER
LEFT	LEFT
LEFTHANDER	LEFTHAND
LEGS	LEG
LEGALISED	LEGALISE
LEGALIZED	LEGALIZE
LEGERING	LEGER
LEGGATT	LEGGATT
LEGISLATES	LEGISLATE
LEGITIMATES	LEGITIMATE
LEGITIMISES	LEGITIMISE
LEGITIMIZES	LEGITIMIZE
LEI	LEI
LEISURED	LEISURE
LEN	LEN
LENDS	LEND
LENDL	LENDL
LENGTHENS	LENGTHEN
LENGTHIER	LENGTHY
LENTEN	LENTEN
LEPRECHAUN	LEPRECHAUN
LES	LES
LESSING	LESS
LESSENS	LESSEN
LEST	LEST
LETS	LET
LETTS	LETT
LETTERED	LETTER
LETTRE	LETTRE
LEV	LEV
LEVELS	LEVEL
LEVERS	LEVER
LEVERAGING	LEVERAGE
LEVITATE	LEVITATE
LEVITT	LEVITT
LEVIED	LEVY
LEWINE	LEWINE
LEYBURN	LEYBURN
LI	LI
LIAISES	LIAISE
LIB	LIB
LIBELLED	LIBEL
LIBERACI�N	LIBERACI�N
LIBERAL	LIBERAL
LIBERALISED	LIBERALISE
LIBERALIZED	LIBERALIZE
LIBERATES	LIBERATE
LIBERTAS	LIBERTAS
LIBRE	LIBRE
LIBRO	LIBRO
LIBS	LIBS
LICENCED	LICENCE
LICENSES	LICENSE
LICKS	LICK
LIDDED	LID
LIES	LIE
LIEBCHEN	LIEBCHEN
LIED	LIED
LIEDER	LIEDER
LIEU	LIEU
LIFTS	LIFT
LIGATED	LIGATE
LIGHTS	LIGHT
LIGHTENS	LIGHTEN
LIGHTHEARTED	LIGHTHEART
LIGHTWATER	LIGHTWATE
LIKES	LIKE
LIKELIEST	LIKELY
LIKENS	LIKEN
LILTING	LILT
LIMS	LIM
LIMBERS	LIMBER
LIMED	LIME
LIMITS	LIMIT
LIMNED	LIMN
LIMPS	LIMP
LIN	LIN
LIND	LIND
LINDEN	LINDEN
LINES	LINE
LINEAGES	LINEAGE
LINGERS	LINGER
LINGUA	LINGUA
LINI	LINI
LINKS	LINK
LIPPED	LIP
LIQUEFIES	LIQUEFY
LIQUIDATED	LIQUIDATE
LIQUIDISE	LIQUIDISE
LIQUIFIED	LIQUIFY
LIS	LIS
LISPS	LISP
LISTS	LIST
LISTENS	LISTEN
LISZT	LISZT
LIT	LIT
LITEM	LITEM
LITHOGRAPHS	LITHOGRAPH
LITIGATED	LITIGATE
LITTERS	LITTER
LITTLEST	LITTL
LITTLE	LITTLE
LITTORAL	LITTORAL
LIV	LIV
LIVES	LIVE
LIVELIEST	LIVELY
LIVENS	LIVEN
LIVERIED	LIVERY
LIVEWIRE	LIVEWIRE
LIVRE	LIVRE
LIX	LIX
LNER	LN
LO	LO
LOA	LOA
LOADS	LOAD
LOAF	LOAF
LOANED	LOAN
LOATHES	LOATHE
LOBS	LOB
LOBBIED	LOBBY
LOBED	LOBE
LOC	LOC
LOCA	LOCA
LOCALISED	LOCALISE
LOCALIZED	LOCALIZE
LOCATES	LOCATE
LOCKS	LOCK
LOCO	LOCO
LODGES	LODGE
LOFOTEN	LOFOTEN
LOFTED	LOFT
LOFTIEST	LOFTY
LOGS	LOG
LOHENGRIN	LOHENGRIN
LOITERING	LOITER
LOLLS	LOLL
LOLLOPING	LOLLOPE
LON	LON
LONELIEST	LONELY
LONGS	LONG
LONGHORN	LONGHORN
LONGUE	LONGUE
LONICERA	LONICERA
LOO	LOO
LOOKS	LOOK
LOOKING	LOOKING
LOOMS	LOOM
LOONIEST	LOONY
LOOPS	LOOP
LOOSEST	LOOS
LOOSES	LOOSE
LOOSENS	LOOSEN
LOOTED	LOOT
LOPPED	LOP
LOPE	LOPE
LOPSIDED	LOPSIDE
LOR	LOR
LORD	LORD
LOS	LOS
LOSES	LOSE
LOT	LOT
LOTHAR	LOTHAR
LOTS	LOTS
LOUDEST	LOUD
LOULOU	LOULOU
LOUNGER	LOUNG
LOUNGED	LOUNGE
LOUNGERS	LOUNGER
LOUSED	LOUSE
LOV	LOV
LOVES	LOVE
LOVELIEST	LOVELY
LOW	LOW
LOWERS	LOWER
LOWLIEST	LOWLY
LOWTHER	LOWTHER
LS	LS
LU	LU
LUBOW	LUBOW
LUBRICATES	LUBRICATE
LUCKIEST	LUCKY
LUFF	LUFF
LUGS	LUG
LUL	LUL
LULLED	LULL
LUMBERS	LUMBER
LUMI�RE	LUMI�RE
LUMPS	LUMP
LUNCHED	LUNCH
LUNE	LUNE
LUNGING	LUNG
LUNGES	LUNGE
LURCHES	LURCH
LURES	LURE
LURKS	LURK
LUSHER	LUSH
LUSTED	LUST
LUSTIER	LUSTY
LUTHER	LUTHER
LUV	LUV
LUX	LUX
LUXE	LUXE
LUXURIATE	LUXURIATE
LV	LV
LIVEN	LVE
LX	LX
LXX	LXX
LY	LY
LYE	LYE
LYNCHED	LYNCH
LYSED	LYSE
MED	M
MA	MA
MACABRE	MACABRE
MACE	MACE
MACHE	MACHE
M�CH�	M�CH�
MACHINA	MACHINA
MACHINES	MACHINE
MACROPHAGES	MACROPHAGE
MADDEST	MAD
MADAME	MADAME
MADCAP	MADCAP
MADDENED	MADDEN
MADDOCK	MADDOCK
MADRE	MADRE
MAESTRO	MAESTRO
MAEVE	MAEVE
MAG	MAG
MAGICKED	MAGICK
MAGNA	MAGNA
MAGNETISED	MAGNETISE
MAGNETIZED	MAGNETIZE
MAGNIFIES	MAGNIFY
MAGNUM	MAGNUM
MAH	MAH
MAI	MAI
MAILED	MAIL
MAILMERGING	MAILMERGE
MAIMED	MAIM
MAIN	MAIN
MAINLINING	MAINLINE
MAINLY	MAINLY
MAINSTREAMING	MAINSTREAM
MAINTAINS	MAINTAIN
MAIR	MAIR
MAIS	MAIS
MAISON	MAISON
MAIT	MAIT
MAITRE	MAITRE
MA�TRE	MA�TRE
MAJEURE	MAJEURE
MAJOR	MAJOR
MAJORED	MAJORE
MAK	MAK
MAKETH	MAKE
MAKEOVER	MAKEOVER
MAL	MAL
MALABSORB	MALABSORB
MALAMUTE	MALAMUTE
MALE	MALE
MALFUNCTIONED	MALFUNCTION
MALIGNED	MALIGN
MALINGERING	MALINGER
MALLING	MALL
MALPASS	MALPASS
MALTING	MALT
MALTESER	MALTESE
MALTREATED	MALTREAT
MANS	MAN
MANA	MANA
MANACLED	MANACLE
MANAGES	MANAGE
MANDATED	MANDATE
MANGE	MANGE
MANGER	MANGER
MANGLES	MANGLE
MANHANDLED	MANHANDLE
MANICURING	MANICURE
MANIFESTS	MANIFEST
MANIPULATES	MANIPULATE
MANNESMANN	MANNESMANN
MANOEUVRED	MANOEUVR
MANOEUVRES	MANOEUVRE
MANSUR	MANSUR
MANTLING	MANTLE
MANUFACTURES	MANUFACTURE
MANURED	MANURE
MANY	MANY
MAPS	MAP
MARS	MAR
MARBLING	MARBLE
MARCEL	MARCEL
MARCHES	MARCH
MARDI	MARDI
MARES	MARE
MAREK	MAREK
MARG	MARG
MARGINALISES	MARGINALISE
MARGINALIZES	MARGINALIZE
MARI	MARI
MARIAGE	MARIAGE
MARIE	MARIE
MARINADED	MARINADE
MARINATED	MARINATE
MARIOT	MARIOT
MARIS	MARIS
MARISE	MARISE
MARJE	MARJE
MARKS	MARK
MARKETS	MARKET
MARKETING	MARKETE
MARMALADE	MARMALADE
MAROONED	MAROON
MARPLES	MARPLE
MARRIES	MARRY
MARRYAT	MARRYAT
MARSHALS	MARSHAL
MARSHALLS	MARSHALL
MART	MART
MARTIALLED	MARTIAL
MARTIN	MARTIN
MARTYRED	MARTYR
MARVELS	MARVEL
MASCHERA	MASCHERA
MASHED	MASH
MASKS	MASK
MASOUD	MASOUD
MASQUERADES	MASQUERADE
MASSED	MASS
MASSACRED	MASSACR
MASSACRE	MASSACRE
MASSAGED	MASSAGE
MASSE	MASSE
MASTERS	MASTER
MASTERMINDED	MASTERMIND
MASTICATED	MASTICATE
MASTURBATES	MASTURBATE
MASUD	MASUD
MATTED	MAT
MATCHES	MATCH
MATCHFACTS	MATCHFACT
MATCHMAKING	MATCHMAKE
MATES	MATE
MATER	MATER
MATERIALISES	MATERIALISE
MATERIALIZES	MATERIALIZE
MATHEW	MATHEW
MATHSOFT	MATHSOFT
MATINS	MATINS
MATRICULATED	MATRICULATE
MATTERS	MATTER
MATURES	MATURE
MAUDE	MAUDE
MAULS	MAUL
MAUNG	MAUNG
MAURICIEN	MAURICIEN
MAXIMISES	MAXIMISE
MAXIMIZES	MAXIMIZE
MAYS	MAY
MAYHAP	MAYHAP
MAYHEW	MAYHEW
MBEST	MB
MCD	MCD
MCI	MCI
MCL	MCL
MCMANUS	MCMANUS
MDC	MDC
ME	ME
MEA	MEA
MEANS	MEAN
MEANDERS	MEANDER
MEASURES	MEASURE
MEATIER	MEATY
MEBBE	MEBBE
MECHANIZED	MECHANIZE
MEDDLED	MEDDLE
MEDE	MEDE
M�DECINS	M�DECINS
MEDIATES	MEDIATE
MEDICATE	MEDICATE
MEDITATES	MEDITATE
MEE	MEE
MEEKEST	MEEK
MEETS	MEET
MEGARRY	MEGARRY
MEGAW	MEGAW
MEIN	MEIN
MEISTERSINGER	MEISTERSINGER
MEKS	MEK
MELD	MELD
MELLOWS	MELLOW
MELTS	MELT
MEM	MEM
MEME	MEME
M�ME	M�ME
MEMOIRE	MEMOIRE
MEMORIAM	MEMORIAM
MEMORISED	MEMORISE
MEMORIZED	MEMORIZE
MENS	MEN
MENACED	MENACE
MENAGE	MENAGE
M�NAGE	M�NAGE
MENDS	MEND
MENSTRUATE	MENSTRUATE
MENT	MENT
MENTHA	MENTHA
MENTHE	MENTHE
MENTIONS	MENTION
MENTIS	MENTIS
MEOWING	MEOW
MER	MER
MERCHANDISE	MERCHANDISE
MERCHANTING	MERCHANT
MERCI	MERCI
MERDE	MERDE
MEREST	MERE
MERGES	MERGE
MERISEL	MERISEL
MERITS	MERIT
MERRIEST	MERRY
MERTHYR	MERTHYR
MERYMOSE	MERYMOSE
MES	MES
MESELF	MESELF
MESHED	MESH
MESMERISED	MESMERISE
MESMERIZED	MESMERIZE
MESSES	MESS
MESSAGING	MESSAGE
MESSE	MESSE
MESSERSCHMITT	MESSERSCHMITT
MESSIER	MESSY
MESURE	MESURE
MET	MET
METABOLISED	METABOLISE
METABOLIZES	METABOLIZE
METAL	METAL
METAMORPHOSES	METAMORPHOSE
METASTASES	METASTASE
METCALF	METCALF
METED	METE
METERED	METER
METH	METH
METHINKS	METHINKS
METHYLATED	METHYLATE
MEURSAULT	MEURSAULT
MEWS	MEW
MEZZO	MEZZO
MG	MG
MHM	MHM
MI	MI
MIA	MIA
MIAOW	MIAOW
MIBBE	MIBBE
MIC	MIC
MICH	MICH
MICRO	MICRO
MICROFILMED	MICROFILM
MICROGRAFX	MICROGRAFX
MICROINJECTED	MICROINJECT
MICROMUSE	MICROMUSE
MICROPORT	MICROPORT
MICROPROGRAMMING	MICROPROGRAM
MICROWAVING	MICROWAVE
MID	MID
MIDDLE	MIDDLE
MIDWINTER	MIDWINTER
MIEUX	MIEUX
MIFFED	MIFF
MIGHTIEST	MIGHTY
MIGRAINE	MIGRAINE
MIGRATES	MIGRATE
MIGUEL	MIGUEL
MII	MII
MIKED	MIKE
MIL	MIL
MILBANK	MILBANK
MILBURN	MILBURN
MILDEST	MILD
MILDEWED	MILDEW
MILITATES	MILITATE
MILKED	MILK
MILLED	MILL
MILLE	MILLE
MILLION	MILLION
MILLIONS	MILLIONS
MILLIPORE	MILLIPORE
MIMES	MIME
MIMICS	MIMIC
MIMICKED	MIMICK
MIN	MIN
MINCED	MINCE
MINCH	MINCH
MINDS	MIND
MINED	MINE
MINERALISED	MINERALISE
MINGLES	MINGLE
MINI	MINI
MINIMISES	MINIMISE
MINIMIZES	MINIMIZE
MINISTERED	MINISTER
MINIST�RE	MINIST�RE
MINISTERO	MINISTERO
MINNOWS	MINNOW
MINTED	MINT
MINTEL	MINTEL
MINUS	MINUS
MINUTES	MINUTE
MINX	MINX
MIO	MIO
MIQUEL	MIQUEL
MIR	MIR
MIRABILIS	MIRABILIS
MIRED	MIRE
MIR�	MIR�
MIROIR	MIROIR
MIRRORS	MIRROR
MIRRORING	MIRRORE
MIS	MIS
MISALIGNED	MISALIGN
MISAPPLIED	MISAPPLY
MISAPPROPRIATED	MISAPPROPRIATE
MISBEHAVED	MISBEHAVE
MISCALCULATED	MISCALCULATE
MISCARRIED	MISCARRY
MISCAST	MISCAST
MISCONCEIVED	MISCONCEIVE
MISCONDUCTED	MISCONDUCT
MISCONSTRUED	MISCONSTRUE
MISCUED	MISCUE
MISDESCRIBES	MISDESCRIBE
MISDIAGNOSED	MISDIAGNOSE
MISDIRECTS	MISDIRECT
MISE	MISE
MISERERE	MISERERE
MISFIRED	MISFIRE
MISHANDLED	MISHANDLE
MISHEARD	MISHEARD
MISHIT	MISHIT
MISINFORMED	MISINFORM
MISINTERPRETS	MISINTERPRET
MISINTERPRETING	MISINTERPRETE
MISJUDGES	MISJUDGE
MISLAID	MISLAY
MISLEADS	MISLEAD
MISMANAGED	MISMANAGE
MISMATCHING	MISMATCH
MISNAMED	MISNAME
MISPLACES	MISPLACE
MISPRICING	MISPRICE
MISQUOTED	MISQUOTE
MISREADS	MISREAD
MISREPRESENTED	MISREPRESENT
MISSES	MISS
MISSA	MISSA
MISSION	MISSION
MISSPELLED	MISSPEL
MISTED	MIST
MISTAKES	MISTAKE
MISTIMED	MISTIME
MISTLETOE	MISTLETOE
MISTREATS	MISTREAT
MISTRUSTS	MISTRUST
MISUNDERSTANDS	MISUNDERSTAND
MISUSES	MISUSE
MIT	MIT
MITHERING	MITHER
MITIGATES	MITIGATE
MITRING	MITR
MITZVAH	MITZVAH
MIXES	MIX
MM	MM
MMC	MMC
MMD	MMD
MMI	MMI
MMM	MMM
MMMM	MMMM
MN	MN
MO	MO
MOANS	MOAN
MOBBED	MOB
MOBILISES	MOBILISE
MOBILIZES	MOBILIZE
MOCKS	MOCK
MODE	MODE
MODELS	MODEL
MODERATES	MODERATE
MODERNE	MODERNE
MODERNISED	MODERNISE
MODERNIZED	MODERNIZE
MODIFIES	MODIFY
MODULATES	MODULATE
MODUS	MODUS
MOI	MOI
MOISTER	MOIST
MOISTENS	MOISTEN
MOISTURISES	MOISTURISE
MOISTURIZE	MOISTURIZE
MOLDED	MOLD
MOLESTED	MOLEST
MOLINIA	MOLINIA
MOLLIS	MOLLI
MOLLIFIED	MOLLIFY
MOLLYCODDLED	MOLLYCODDLE
MOLTO	MOLTO
MOM	MOM
MOMENTO	MOMENTO
MON	MON
MOND	MOND
MONDE	MONDE
MONITORS	MONITOR
MONKEYING	MONKEY
MONOCULTURE	MONOCULTURE
MONOPOLISES	MONOPOLISE
MONOPOLIZES	MONOPOLIZE
MONSIEUR	MONSIEUR
MONTAGNE	MONTAGNE
MOOING	MOO
MOOCHING	MOOCH
MOODIER	MOODY
MOON	MOON
MOONLIGHT	MOONLIGHT
MOORED	MOOR
MOORGATE	MOORGATE
MOOTS	MOOT
MOPS	MOP
MOPE	MOPE
MOR	MOR
MORAL	MORAL
MORALISE	MORALISE
MORALIZE	MORALIZE
MORE	MORE
MORGEN	MORGEN
MORN	MORN
MORT	MORT
MORTARED	MORTARE
MORTE	MORTE
MORTEM	MORTEM
MORTEMS	MORTEMS
MORTGAGED	MORTGAGE
MORTIFIED	MORTIFY
MORTIS	MORTIS
MOS	MOS
MOSEY	MOSEY
MOSSES	MOSS
MOST	MOST
MOT	MOT
MOTH	MOTH
MOTHBALLED	MOTHBAL
MOTHERED	MOTHER
MOTION	MOTION
MOTIVATES	MOTIVATE
MOTO	MOTO
MOTORS	MOTOR
MOTORING	MOTORE
MOTORIZED	MOTORIZE
MOTTLING	MOTTLE
MOULDS	MOULD
MOULDERING	MOULDER
MOULIN	MOULIN
MOULOUD	MOULOUD
MOULTS	MOULT
MOUNTS	MOUNT
MOUNTAINEER	MOUNTAINEER
MOURNS	MOURN
MOUTHED	MOUTH
MOUTHWATERING	MOUTHWATER
MOUVEMENT	MOUVEMENT
MOVES	MOVE
MOVIMENTO	MOVIMENTO
MOVIMIENTO	MOVIMIENTO
MOWS	MOW
MOWN	MOWN
MOZ	MOZ
MR	MR
MU	MU
MUCH	MUCH
MUCKED	MUCK
MUDDLES	MUDDLE
MUDDIED	MUDDY
MUFFING	MUFF
MUFFLES	MUFFLE
MUGGED	MUG
MULCHING	MULCH
MULLS	MULL
MULLIONED	MULLION
MULTI	MULTI
MULTIMILLION	MULTIMILLION
MULTIPLIES	MULTIPLY
MULTIPROCESSING	MULTIPROCESS
MULTITASKING	MULTITASK
MULTIVIEW	MULTIVIEW
MUMBLES	MUMBLE
MUMM	MUMM
MUN	MUN
MUNCHES	MUNCH
MUNDO	MUNDO
MURDERS	MURDER
MURES	MURE
MURKIEST	MURKY
MURMURS	MURMUR
MURTACH	MURTACH
MURTEN	MURTEN
MUS	MUS
MUSCLED	MUSCLE
MUSES	MUSE
MUS�E	MUS�E
MUS�ES	MUS�ES
MUSEO	MUSEO
MUSETTE	MUSETTE
MUSH	MUSH
MUSHROOMED	MUSHROOM
MUSICA	MUSICA
MUSICHE	MUSICHE
MUSIK	MUSIK
MUSIQUE	MUSIQUE
MUSSED	MUSS
MUSTERS	MUSTER
MUSTILL	MUSTILL
MUTANDIS	MUTANDIS
MUTATES	MUTATE
MUTATIS	MUTATIS
MUTES	MUTE
MUTILATED	MUTILATE
MUTINIED	MUTINY
MUTTERS	MUTTER
MUY	MUY
MUZAK	MUZAK
MUZZLED	MUZZLE
MX	MX
MY	MY
MYRTLE	MYRTLE
MYSELF	MYSELF
MYSTIFIES	MYSTIFY
N	N
NA	NA
NABS	NAB
NACAB	NACAB
NACH	NACH
NACHTMUSIK	NACHTMUSIK
NACIONAL	NACIONAL
NADA	NADA
NADER	NADER
NADINE	NADINE
NADIRPUR	NADIRPUR
NAEP	NAEP
NAGS	NAG
NAH	NAH
NAILS	NAIL
NAJIBULLAH	NAJIBULLAH
NAMES	NAME
NANNERL	NANNERL
NAP	NAP
NARKED	NARK
NARRATES	NARRATE
NARROWS	NARROW
NASTIES	NASTY
NAT	NAT
NATIONAL	NATIONAL
NATIONALE	NATIONALE
NATIONALISED	NATIONALISE
NATIONALIZED	NATIONALIZE
NATIONAUX	NATIONAUX
NATTERING	NATTER
NATURAE	NATURAE
NATURALISED	NATURALISE
NATURALIZES	NATURALIZE
NATUREL	NATUREL
NAUGHT	NAUGHT
NAUGHTIEST	NAUGHTY
NAUSEAM	NAUSEAM
NAUSEATED	NAUSEATE
NAVIGATES	NAVIGATE
NAW	NAW
NAY	NAY
NAZIONALE	NAZIONALE
NB	NB
NCUBE	NCUBE
NE	NE
NEA	NEA
NEARS	NEAR
NEATEST	NEAT
NEATENED	NEATEN
NEATH	NEATH
NEC	NEC
NECESSITATES	NECESSITATE
NECK	NECK
NEE	NEE
N�E	N�E
NEEDS	NEED
NEEDLING	NEEDLE
NEEDIEST	NEEDY
NEGATES	NEGATE
NEGATIVED	NEGATIVE
NEGLECTS	NEGLECT
NEGOTIATES	NEGOTIATE
NEI	NEI
NEIGHING	NEIGH
NEIGHBOURING	NEIGHBOUR
NEIN	NEIN
NEL	NEL
NEM	NEM
NER	NER
NERVED	NERVE
NERVOS	NERVOS
NESTS	NEST
NESTLES	NESTLE
NETTED	NET
NETTLED	NETTLE
NETVIEW	NETVIEW
NETWORKED	NETWORK
NEUE	NEUE
NEURONES	NEURONE
NEUROPEPTIDE	NEUROPEPTIDE
NEUTERED	NEUTER
NEUTRALISES	NEUTRALISE
NEUTRALIZES	NEUTRALIZE
NEV	NEV
NEVIL	NEVIL
NEW	NEW
NEWCASTLE	NEWCASTLE
NEWE	NEWE
NEWTS	NEWT
NEXT	NEXT
NEZ	NEZ
NFER	NF
NI	NI
NIALL	NIALL
NIBBLED	NIBBLE
NICEST	NICE
NICHT	NICHT
NICKS	NICK
NICKLAUS	NICKLAUS
NICKNAMED	NICKNAME
NIE	NIE
NIEVE	NIEVE
NIG	NIG
NIGER	NIGER
NIGGER	NIGGER
NIGGLES	NIGGLE
NIGH	NIGH
NIGHTCLUBBING	NIGHTCLUB
NIKWAX	NIKWAX
NILS	NIL
NIN	NIN
NINE	NINE
NINES	NINES
NINET	NINET
NINETEEN	NINETEEN
NINETEENS	NINETEENS
NINETEENTH	NINETEENTH
NINETIES	NINETIES
NINETIETH	NINETIETH
NINETY	NINETY
NI�O	NI�O
NINTH	NINTH
NINTHS	NINTHS
NIPS	NIP
NIPPLE	NIPPLE
NIREX	NIREX
NISI	NISI
NITROCELLULOSE	NITROCELLULOSE
NITTY	NITTY
NIVVER	NIVVER
NIXED	NIX
NKRUMAH	NKRUMAH
NM	NM
NO	NO
NOB	NOB
NOBBLED	NOBBLE
NOBIS	NOBIS
NOBLEST	NOBL
NOBLESSE	NOBLESSE
NOBODY	NOBODY
NOCES	NOCES
NOCKED	NOCK
NODS	NOD
NODED	NODE
NOES	NOE
NOIR	NOIR
NOIRE	NOIRE
NOISIEST	NOISY
NOM	NOM
NOMINATES	NOMINATE
NON	NON
NONE	NONE
NOO	NOO
NOODLES	NOODLE
NOPCES	NOPCES
NOPE	NOPE
NOR	NOR
NORD	NORD
NORM	NORM
NORMA	NORMA
NORMAL	NORMAL
NORMALISES	NORMALISE
NORMALIZED	NORMALIZE
NORMANDE	NORMANDE
NORSE	NORSE
NORSK	NORSK
NORTH	NORTH
NOS	NOS
NOSED	NOSE
NOSEDIVE	NOSEDIVE
NOSTER	NOSTER
NOSTRUM	NOSTRUM
NOT	NOT
NOTATED	NOTATE
NOTCHES	NOTCH
NOTES	NOTE
NOTH	NOTH
NOTHING	NOTHING
NOTICES	NOTICE
NOTIFIES	NOTIFY
NOTWITHSTANDING	NOTWITHSTANDING
NOUGHT	NOUGHT
NOURISHES	NOURISH
NOURSE	NOURSE
NOUS	NOUS
NOUVEAU	NOUVEAU
NOUVEAUX	NOUVEAUX
NOUVELLE	NOUVELLE
NOVA	NOVA
NOVE	NOVE
NOW	NOW
NOWT	NOWT
NOZZE	NOZZE
NR	NR
NS	NS
NSAID	NSAY
NT	NT
NTH	NTH
NU	NU
NUANCED	NUANCE
NUCLEOTIDE	NUCLEOTIDE
NUDGES	NUDGE
NUEE	NUEE
NUEES	NUEES
NUER	NUER
NUFFINK	NUFFINK
NUIT	NUIT
NUKE	NUKE
NULLIFIES	NULLIFY
NUM	NUM
NUMBS	NUMB
NUMBERS	NUMBER
NUMERATE	NUMERATE
NUNC	NUNC
NUOVA	NUOVA
NUR	NUR
NURSES	NURSE
NURTURES	NURTURE
NUTS	NUT
NUZZLES	NUZZLE
O	O
OAKESHOTT	OAKESHOTT
OALDCE	OALDCE
OBS	OB
OBER	OBER
OBERHAUSEN	OBERHAUSEN
OBEYS	OBEY
OBFUSCATES	OBFUSCATE
OBJECTS	OBJECT
OBJECTIFIES	OBJECTIFY
OBJET	OBJET
OBJETS	OBJETS
OBLIGATED	OBLIGATE
OBLIGES	OBLIGE
OBLITERATES	OBLITERATE
OBSCURA	OBSCURA
OBSCURES	OBSCURE
OBSERVES	OBSERVE
OBSESSES	OBSESS
OBSTRUCTS	OBSTRUCT
OBTAINS	OBTAIN
OBTRUDES	OBTRUDE
OBVIATES	OBVIATE
OBVIOUS	OBVIOUS
OC	OC
OCCASIONS	OCCASION
OCCLUDES	OCCLUDE
OCCUPIES	OCCUPY
OCCURS	OCCUR
OCCURED	OCCURE
OCH	OCH
OCT	OCT
OD	OD
ODER	ODER
ODOMETER	ODOMETE
OF	OF
OFFED	OFF
OFFENDS	OFFEND
OFFERS	OFFER
OFFIAH	OFFIAH
OFFICIATES	OFFICIATE
OFFICIO	OFFICIO
OFFLINED	OFFLINE
OFFLOADS	OFFLOAD
OFFSETS	OFFSET
OFTEN	OFTEN
OFTHE	OFTHE
OGGY	OGGY
OGLE	OGLE
OH	OH
OHHHH	OHHHH
OI	OI
OILS	OIL
OILSEEDS	OILSEED
OILIER	OILY
OKAYED	OKAY
OL	OL
OLAF	OLAF
OLD	OLD
OLE	OLE
OLIGONUCLEOTIDES	OLIGONUCLEOTIDE
OMF	OMF
OMITS	OMIT
OMNI	OMNI
ON	ON
ONCE	ONCE
ONE	ONE
ONESELF	ONESELF
ONTO	ONTO
ONYX	ONYX
OO	OO
OOH	OOH
OOO	OOO
OOOH	OOOH
OOOOH	OOOOH
OOP	OOP
OOPS	OOPS
OOR	OOR
OOT	OOT
OOZES	OOZE
OP	OP
OPE	OPE
OPENS	OPEN
OPENCASTING	OPENCAST
OPERA	OPERA
OPERANDI	OPERANDI
OPERATES	OPERATE
OPERATIONALISE	OPERATIONALISE
OPERATIONALIZED	OPERATIONALIZE
OPIATE	OPIATE
OPINES	OPINE
OPINIONATED	OPINIONATE
OPP	OPP
OPPO	OPPO
OPPOSES	OPPOSE
OPPOSITE	OPPOSITE
OPPRESSES	OPPRESS
OPTS	OPT
OPTIMISES	OPTIMISE
OPTIMIZES	OPTIMIZE
OPTIONED	OPTION
OPUS	OPUS
OR	OR
ORA	ORA
ORBITS	ORBIT
ORCHESTRATES	ORCHESTRATE
ORD	ORD
ORDAINS	ORDAIN
ORDERS	ORDER
ORDINAIRE	ORDINAIRE
ORF	ORF
ORG	ORG
ORGANISES	ORGANISE
ORGANIZES	ORGANIZE
ORI	ORI
ORIENTS	ORIENT
ORIENTATES	ORIENTATE
ORIGINATES	ORIGINATE
ORMANROYD	ORMANROYD
ORMROD	ORMROD
ORNAMENTED	ORNAMENT
OS	OS
OSCILLATES	OSCILLATE
OSF	OSF
OSKAR	OSKAR
OST	OST
OSTRACISED	OSTRACISE
OSTRACIZED	OSTRACIZE
OSTRICH	OSTRICH
OT	OT
OTH	OTH
OTHER	OTHER
OTT	OTT
OU	OU
OUCH	OUCH
OUI	OUI
OURS	OURS
OURSELF	OURSELF
OURSELVES	OURSELVES
OUSTS	OUST
OUT	OUT
OUTBID	OUTBID
OUTBOUND	OUTBOUND
OUTBREEDING	OUTBREED
OUTCLASSED	OUTCLASS
OUTCROPPING	OUTCROP
OUTDATED	OUTDATE
OUTDISTANCED	OUTDISTANCE
OUTDO	OUTDO
OUTDONE	OUTDONE
OUTFACED	OUTFACE
OUTFITTING	OUTFIT
OUTFLANKED	OUTFLANK
OUTGASSED	OUTGASS
OUTGREW	OUTGREW
OUTGROWS	OUTGROW
OUTGUNNED	OUTGUN
OUTLASTS	OUTLAST
OUTLAWS	OUTLAW
OUTLINES	OUTLINE
OUTLIVES	OUTLIVE
OUTLIER	OUTLY
OUTMANOEUVRED	OUTMANOEUVRE
OUTNUMBERS	OUTNUMBER
OUTPACES	OUTPACE
OUTPERFORMS	OUTPERFORM
OUTPLAYED	OUTPLAY
OUTPOINTED	OUTPOINT
OUTPOSTED	OUTPOST
OUTPUTS	OUTPUT
OUTRAN	OUTRAN
OUTRANKS	OUTRANK
OUTREACH	OUTREACH
OUTRUNS	OUTRUN
OUTSCORING	OUTSCORE
OUTSELLS	OUTSELL
OUTSHINES	OUTSHINE
OUTSHONE	OUTSHONE
OUTSIDE	OUTSIDE
OUTSMARTED	OUTSMART
OUTSOLD	OUTSOLD
OUTSOURCING	OUTSOURCE
OUTSTAYED	OUTSTAY
OUTSTRIPS	OUTSTRIP
OUTVOTED	OUTVOTE
OUTWEIGHS	OUTWEIGH
OUTWITS	OUTWIT
OUTWITH	OUTWITH
OV	OV
OVE	OVE
OVERING	OVER
OVERARCHING	OVERARCH
OVERAWED	OVERAWE
OVERBALANCED	OVERBALANCE
OVERBOOKED	OVERBOOK
OVERBORNE	OVERBORNE
OVERBURDENED	OVERBURDEN
OVERCHARGED	OVERCHARGE
OVERCOMES	OVERCOME
OVERCOMPENSATE	OVERCOMPENSATE
OVERCOOKED	OVERCOOK
OVERCROWD	OVERCROWD
OVERDETERMINED	OVERDETERMINE
OVERDEVELOPED	OVERDEVELOPE
OVERDONE	OVERDO
OVERDOSED	OVERDOSE
OVERDRAW	OVERDRAW
OVERDRESSED	OVERDRESS
OVERDRIVING	OVERDRIVE
OVERDUBBED	OVERDUB
OVEREAT	OVEREAT
OVEREMPHASISES	OVEREMPHASISE
OVEREMPHASIZED	OVEREMPHASIZE
OVERESTIMATES	OVERESTIMATE
OVEREXPRESSED	OVEREXPRESS
OVERFED	OVERF
OVERFEED	OVERFEED
OVERFILLING	OVERFIL
OVERFISHED	OVERFISH
OVERFLOWS	OVERFLOW
OVERFLYING	OVERFLY
OVERFUNDING	OVERFUND
OVERGROWN	OVERGROW
OVERHANGING	OVERHANG
OVERHAULED	OVERHAUL
OVERHEARS	OVERHEAR
OVERHEATS	OVERHEAT
OVERHUNG	OVERHUNG
OVERLAIN	OVERLAIN
OVERLAPS	OVERLAP
OVERLAYS	OVERLAY
OVERLIE	OVERLIE
OVERLOADED	OVERLOAD
OVERLOOKS	OVERLOOK
OVERLIES	OVERLY
OVERMANNING	OVERMAN
OVERPAINTED	OVERPAINT
OVERPAID	OVERPAY
OVERPLAYED	OVERPLAY
OVERPOWERS	OVERPOWER
OVERPRICED	OVERPRICE
OVERPRINTED	OVERPRINT
OVERRAN	OVERRAN
OVERRATE	OVERRATE
OVERREACHED	OVERREACH
OVERREACT	OVERREACT
OVERREPRESENTED	OVERREPRESENT
OVERRIDDEN	OVERRIDDEN
OVERRIDES	OVERRIDE
OVERRODE	OVERRODE
OVERRULES	OVERRULE
OVERRUNS	OVERRUN
OVERSAW	OVERSAW
OVERSEAS	OVERSEAS
OVERSEES	OVERSEE
OVERSEEN	OVERSEEN
OVERSHADOWS	OVERSHADOW
OVERSHOOTS	OVERSHOOT
OVERSHOT	OVERSHOT
OVERSIMPLIFIES	OVERSIMPLIFY
OVERSIZED	OVERSIZE
OVERSLEPT	OVERSLEPT
OVERSPENDS	OVERSPEND
OVERSPENT	OVERSPENT
OVERSTATES	OVERSTATE
OVERSTAYED	OVERSTAY
OVERSTEER	OVERSTEER
OVERSTEPPED	OVERSTEP
OVERSTOCK	OVERSTOCK
OVERSTRESSED	OVERSTRESS
OVERSTRETCHED	OVERSTRETCH
OVERSUBSCRIBED	OVERSUBSCRIBE
OVERSUPPLIED	OVERSUPPLY
OVERTAKES	OVERTAKE
OVERTAXED	OVERTAX
OVERTHREW	OVERTHREW
OVERTHROWS	OVERTHROW
OVERTHRUSTING	OVERTHRUST
OVERTIRED	OVERTIRE
OVERTURES	OVERTURE
OVERTURNS	OVERTURN
OVERUSED	OVERUSE
OVERVALUED	OVERVALUE
OVERVIEWING	OVERVIEW
OVERWHELMS	OVERWHELM
OVERWINTERS	OVERWINTER
OVERWORKED	OVERWORK
OVERWRITES	OVERWRITE
OVERWRITTEN	OVERWRITTEN
OVERWROUGHT	OVERWROUGHT
�VP	�VP
OVULATE	OVULATE
OWS	OW
OWAIN	OWAIN
OWES	OWE
OWERS	OWER
OWNS	OWN
OWT	OWT
OXIDISED	OXIDISE
OXIDIZES	OXIDIZE
OXYGENATE	OXYGENATE
OY	OY
P	P
PA	PA
PACES	PACE
PACEM	PACEM
PACIFIED	PACIFY
PACKED	PACK
PACKAGED	PACKAGE
PADDED	PAD
PADDLES	PADDLE
PADLOCKED	PADLOCK
PADRAIG	PADRAIG
PAGES	PAGE
PAH	PAH
PAIGE	PAIGE
PAINS	PAIN
PAINEWEBBER	PAINEWEBBER
PAINTS	PAINT
PAIRED	PAIR
PALES	PALE
PALLED	PALL
PALLETIZE	PALLETIZE
PALLIATE	PALLIATE
PALLISTER	PALLIST
PALMED	PALM
PALMIER	PALMY
PALOMA	PALOMA
PALPATED	PALPATE
PALUSTRIS	PALUSTRIS
PAMIDRONATE	PAMIDRONATE
PAMPERS	PAMPER
PANS	PAN
PANDERS	PANDER
PANELLED	PANEL
PANICS	PANIC
PANICKED	PANICK
PANMURE	PANMURE
PANNIER	PANNY
PANT	PANT
PAPERED	PAPER
PAPERBACKED	PAPERBACK
PAPIER	PAPIER
PAPIER	PAPY
PARRED	PAR
PARA	PARA
PARACHUTED	PARACHUTE
PARADES	PARADE
PARADIS	PARADIS
PARAGLIDING	PARAGLIDE
PARAGRAPHING	PARAGRAPH
PARALLELS	PARALLEL
PARALLELED	PARALLELE
PARALYSES	PARALYSE
PARAPHRASES	PARAPHRASE
PARASITISES	PARASITISE
PARASITIZED	PARASITIZE
PARC	PARC
PARCELS	PARCEL
PARCELFORCE	PARCELFORCE
PARDONS	PARDON
PARED	PARE
PARENTING	PARENT
PARENTIS	PARENTIS
PARES	PARES
PARIBUS	PARIBUS
PARIS	PARIS
PARKS	PARK
PARLE	PARLE
PARLER	PARLER
PARLEY	PARLEY
PARODIES	PARODY
PAROLE	PAROLE
PARROT	PARROT
PARRIED	PARRY
PARSED	PARSE
PARTS	PART
PARTAKES	PARTAKE
PARTE	PARTE
PARTEI	PARTEI
PARTI	PARTI
PARTIC	PARTIC
PARTICIPATES	PARTICIPATE
PARTICULARLY	PARTICULARLY
PARTIDO	PARTIDO
PARTIJ	PARTIJ
PARTITIONS	PARTITION
PARTITO	PARTITO
PARTNERED	PARTNER
PARTOOK	PARTOOK
PARTIES	PARTY
PAS	PAS
PASSES	PASS
PASSANT	PASSANT
PASSE	PASSE
PASSU	PASSU
PASTING	PAST
PASTED	PASTE
PASTURED	PASTURE
PATS	PAT
PATCHED	PATCH
PATE	PATE
P�T�	P�T�
PATEN	PATEN
PATENTED	PATENT
PATINEURS	PATINEURS
PATRIA	PATRIA
PATRICE	PATRICE
PATROLS	PATROL
PATRONISES	PATRONISE
PATRONIZES	PATRONIZE
PATTEN	PATTEN
PATTERING	PATTER
PATTERN	PATTERN
PAU	PAU
PAUSES	PAUSE
PAVES	PAVE
PAWED	PAW
PAWNED	PAWN
PAX	PAX
PAYS	PAY
PB	PB
PE	PE
PEACEKEEPING	PEACEKEEP
PEACEMAKING	PEACEMAKE
PEAKS	PEAK
PEAL	PEAL
PEATING	PEAT
PECKS	PECK
PEDALS	PEDAL
PEDDLES	PEDDLE
PEDESTRIANISE	PEDESTRIANISE
PEES	PEE
PEEK	PEEK
PEELS	PEEL
PEEPS	PEEP
PEERS	PEER
PEGGED	PEG
PEINTURE	PEINTURE
PELLETED	PELLETE
PELTED	PELT
PENS	PEN
PENALISES	PENALISE
PENALIZES	PENALIZE
PENCILLED	PENCIL
PENCOM	PENCOM
PENDING	PENDING
PENDULA	PENDULA
PENETRATES	PENETRATE
PENSIONED	PENSION
PEO	PEO
PEOP	PEOP
PEOPLED	PEOPLE
PEOPLESOFT	PEOPLESOFT
PEP	PEP
PEPPERED	PEPPER
PER	PER
PERAMBULATED	PERAMBULATE
PERCE	PERCE
PERCEIVES	PERCEIVE
PERCENT	PERCENT
PERCHES	PERCH
PERCOLATES	PERCOLATE
PERFECTS	PERFECT
PERFORATED	PERFORATE
PERFORMS	PERFORM
PERFUMED	PERFUME
PERFUSED	PERFUSE
PERI	PERI
PERISHES	PERISH
PERJURED	PERJURE
PERKS	PERK
PERKIER	PERKY
PERMED	PERM
PERMEATES	PERMEATE
PERMITS	PERMIT
PERMUTES	PERMUTE
PERPETRATES	PERPETRATE
PERPETUATES	PERPETUATE
PERPLEXED	PERPLEX
PERSECUTED	PERSECUTE
PERSEVERING	PERSEVER
PERSEVERES	PERSEVERE
PERSISTS	PERSIST
PERSONA	PERSONA
PERSONAE	PERSONAE
PERSONALISED	PERSONALISE
PERSONALIZES	PERSONALIZE
PERSONIFIES	PERSONIFY
PERSPIRE	PERSPIRE
PERSUADES	PERSUADE
PERTAINS	PERTAIN
PERTEX	PERTEX
PERTURBS	PERTURB
PERU	PERU
PERUSES	PERUSE
PERVADES	PERVADE
PERVERTED	PERVERT
PESTERED	PESTER
PETTED	PET
PETERS	PETER
PETITS	PETIT
PETITE	PETITE
PETITIONED	PETITION
PETITS	PETITS
PETRIFIES	PETRIFY
PETROCHEMICALS	PETROCHEMICAL
PETTS	PETT
PETTIER	PETTY
PETUR	PETUR
PEU	PEU
PEUPLE	PEUPLE
PEUT	PEUT
PGE	PGE
PH	PH
PHAR	PHAR
PHASED	PHASE
PHEROMONES	PHEROMONE
PHEW	PHEW
PHIL	PHIL
PHILADELPHUS	PHILADELPHUS
PHILANDERING	PHILANDER
PHILIP	PHILIP
PHILOSOPHIE	PHILOSOPHIE
PHILOSOPHISE	PHILOSOPHISE
PHILOSOPHIZE	PHILOSOPHIZE
PHO	PHO
PHONES	PHONE
PHONIEST	PHONY
PHOSPHORYLATES	PHOSPHORYLATE
PHOTO	PHOTO
PHOTOCOPIED	PHOTOCOPY
PHOTOGRAPHS	PHOTOGRAPH
PHOTOMULTIPLIER	PHOTOMULTIPLY
PHOTOSYNTHESISE	PHOTOSYNTHESISE
PHRASED	PHRASE
PHWORGH	PHWORGH
PHYSIO	PHYSIO
PI	PI
PIANO	PIANO
PIC	PIC
PICKS	PICK
PICKET	PICKET
PICKETED	PICKETE
PICKLED	PICKLE
PICNIC	PICNIC
PICNICKED	PICNICK
PICT	PICT
PICTURES	PICTURE
PIDDLED	PIDDLE
PIECES	PIECE
PI�CE	PI�CE
PIERCES	PIERCE
PIERPONT	PIERPONT
PIERRE	PIERRE
PIET	PIET
PIETRO	PIETRO
PIGGING	PIG
PIGOTT	PIGOTT
PIKE	PIKE
PILATE	PILATE
PILED	PILE
PILFERED	PILFER
PILLAGED	PILLAGE
PILLORIES	PILLORY
PILLOWED	PILLOW
PILOTS	PILOT
PILOTED	PILOTE
PIM	PIM
PIMPING	PIMP
PINS	PIN
PINCHES	PINCH
PINDER	PINDER
PINES	PINE
PINGING	PING
PINGED	PINGE
PINIONED	PINION
PINKER	PINK
PINOT	PINOT
PINPOINTS	PINPOINT
PIONEERED	PIONEER
PIOTR	PIOTR
PIPPED	PIP
PIPES	PIPE
PIPETTED	PIPET
PIQUED	PIQUE
PIRATED	PIRATE
PIROUETTING	PIROUET
PISSES	PISS
PISTONED	PISTON
PITS	PIT
PITCHES	PITCH
PITCHFORKED	PITCHFORK
PITTURA	PITTURA
PITIES	PITY
PIVOTS	PIVOT
PIVOTED	PIVOTE
PL	PL
PLA	PLA
PLACATED	PLACATE
PLACES	PLACE
PLAGIARISING	PLAGIARISE
PLAGIARIZED	PLAGIARIZE
PLAGUES	PLAGUE
PLAINEST	PLAIN
PLAITED	PLAIT
PLANS	PLAN
PLANED	PLANE
PLANKED	PLANK
PLANTS	PLANT
PLASHED	PLASH
PLASTERS	PLASTER
PLAT	PLAT
PLATED	PLATE
PLAYS	PLAY
PLED	PLE
PLEADS	PLEAD
PLEASANTEST	PLEASANT
PLEASES	PLEASE
PLEASURED	PLEASURE
PLEATING	PLEAT
PLEDGES	PLEDGE
PLENTY	PLENTY
PLODS	PLOD
PLONKED	PLONK
PLOPPED	PLOP
PLOTS	PLOT
PLOUGHED	PLOUGH
PLUCKS	PLUCK
PLUGS	PLUG
PLUMBS	PLUMB
PLUMING	PLUME
PLUMMETS	PLUMMET
PLUMMETED	PLUMMETE
PLUMPS	PLUMP
PLUNDERS	PLUNDER
PLUNGER	PLUNG
PLUNGES	PLUNGE
PLUNGERS	PLUNGER
PLUNKED	PLUNK
PLUS	PLUS
PLIES	PLY
PMODEL	PMODEL
PO	PO
POACHED	POACH
POCKED	POCK
POCKET	POCKET
POCKETED	POCKETE
POCKMARKED	POCKMARK
POGOING	POGO
POI	POI
POINTS	POINT
POINTES	POINTES
POISED	POISE
POISONS	POISON
POKES	POKE
POL	POL
POLARISED	POLARISE
POLARIZED	POLARIZE
POLED	POLE
POLI	POLI
POLICES	POLICE
POLICYHOLDERS	POLICYHOLDER
POLIS	POLIS
POLISHES	POLISH
POLITEST	POLITE
POLITICISED	POLITICISE
POLITICIZED	POLITICIZE
POLLED	POLL
POLLACK	POLLACK
POLLINATES	POLLINATE
POLLOI	POLLOI
POLLUTES	POLLUTE
POLYUNSATURATED	POLYUNSATURATE
POMME	POMME
POMMES	POMMES
PON	PON
PONCING	PONCE
POND	POND
PONDERS	PONDER
PONG	PONG
PONTING	PONT
PONTIFICATES	PONTIFICATE
POO	POO
POOLED	POOL
POOPED	POOP
POOREST	POOR
POPS	POP
POPULAIRE	POPULAIRE
POPULAR	POPULAR
POPULARISED	POPULARISE
POPULARIZED	POPULARIZE
POPULARLY	POPULARLY
POPULATED	POPULATE
POR	POR
PORES	PORE
PORN	PORN
PORTED	PORT
PORTE	PORTE
PORTEND	PORTEND
PORTIONED	PORTION
PORTO	PORTO
PORTRAIT	PORTRAIT
PORTRAYS	PORTRAY
PORTS	PORTS
POS	POS
POSES	POSE
POSHEST	POSH
POSITS	POSIT
POSITIONS	POSITION
POSIX	POSIX
POSSES	POSS
POSSESSES	POSSESS
POSTS	POST
POSTCODE	POSTCODE
POSTDATES	POSTDATE
POSTE	POSTE
POSTERIORI	POSTERIORI
POSTMARKED	POSTMARK
POSTMULTIPLYING	POSTMULTIPLY
POSTPONING	POSTPON
POSTPONES	POSTPONE
POSTULATES	POSTULATE
POSTURING	POSTURE
POTTED	POT
POTENTIATES	POTENTIATE
POTHOLING	POTHOLE
POTTERS	POTTER
POU	POU
POUCHED	POUCH
POULTICE	POULTICE
POUNCES	POUNCE
POUNDS	POUND
POURS	POUR
POURRI	POURRI
POUT	POUT
POW	POW
POWDERED	POWDER
POWERS	POWER
POWERBOATING	POWERBOAT
POWEROPEN	POWEROPEN
POWERSOFT	POWERSOFT
PR	PR
PRA	PRA
PRACTICES	PRACTICE
PRACTISES	PRACTISE
PRAISES	PRAISE
PRANCING	PRANCE
PRATE	PRATE
PRATTLE	PRATTLE
PRAYS	PRAY
PRE	PRE
PREACHES	PREACH
PRECEDES	PRECEDE
PRECEEDING	PRECEED
PRECIPITATES	PRECIPITATE
PRECIS	PRECIS
PRECLUDES	PRECLUDE
PRECONDITIONED	PRECONDITION
PREDATES	PREDATE
PREDECEASED	PREDECEASE
PREDESTINED	PREDESTINE
PREDETERMINED	PREDETERMINE
PREDICATES	PREDICATE
PREDICTS	PREDICT
PREDISPOSES	PREDISPOSE
PREDOMINATES	PREDOMINATE
PREEMPTED	PREEMPT
PREEN	PREEN
PREF	PREF
PREFACES	PREFACE
PREFECT	PREFECT
PREFERS	PREFER
PREFIGURES	PREFIGURE
PREFIXED	PREFIX
PREHEATED	PREHEAT
PREINCUBATED	PREINCUBATE
PREJUDGED	PREJUDGE
PREJUDICES	PREJUDICE
PRELUDE	PRELUDE
PREMEDITATED	PREMEDITATE
PREMIERED	PREMIER
PREMIERES	PREMIERE
PREMISED	PREMISE
PREMISSED	PREMISS
PREMULTIPLIED	PREMULTIPLY
PREOCCUPIES	PREOCCUPY
PREORDAINED	PREORDAIN
PREPARES	PREPARE
PRES	PRES
PRESAGES	PRESAGE
PRESCRIBES	PRESCRIBE
PRESELECTED	PRESELECT
PRESENTS	PRESENT
PRESERVES	PRESERVE
PRESETS	PRESET
PRESIDES	PRESIDE
PRESSES	PRESS
PRESSURED	PRESSURE
PRESSURISED	PRESSURISE
PRESSURIZED	PRESSURIZE
PRESTEL	PRESTEL
PRESTO	PRESTO
PRESUMES	PRESUME
PRESUPPOSES	PRESUPPOSE
PRETENDS	PRETEND
PRETREATED	PRETREAT
PRETTIFIED	PRETTIFY
PRETTIEST	PRETTY
PREVAILS	PREVAIL
PREVARICATES	PREVARICATE
PREVENTS	PREVENT
PREVIEWED	PREVIEW
PREYS	PREY
PRI	PRI
PRICES	PRICE
PRICKS	PRICK
PRICKLE	PRICKLE
PRICIEST	PRICY
PRIDES	PRIDE
PRIM	PRIM
PRIMA	PRIMA
PRIMES	PRIME
PRIMEUR	PRIMEUR
PRIMO	PRIMO
PRIMPING	PRIMP
PRIMUS	PRIMUS
PRINCEPS	PRINCEP
PRINCES	PRINCES
PR�NCIPE	PR�NCIPE
PRINCIPESSA	PRINCIPESSA
PRINCIPIA	PRINCIPIA
PRINCIPLED	PRINCIPLE
PRINTS	PRINT
PRINTEMPS	PRINTEMPS
PRIORI	PRIORI
PRIORITISED	PRIORITISE
PRIORITIZES	PRIORITIZE
PRISED	PRISE
PRIVATEERING	PRIVATEER
PRIVATISED	PRIVATISE
PRIVATIZED	PRIVATIZE
PRIVILEGE	PRIVILEGE
PRIX	PRIX
PRIZES	PRIZE
PRO	PRO
PROB	PROB
PROBATE	PROBATE
PROBES	PROBE
PROBLEMATIZED	PROBLEMATIZE
PROCEEDS	PROCEED
PROCESSES	PROCESS
PROCLAIMS	PROCLAIM
PROCRASTINATE	PROCRASTINATE
PROCREATE	PROCREATE
PROCURES	PROCURE
PRODS	PROD
PRODRIVE	PRODRIVE
PRODUCES	PRODUCE
PRODUCTISED	PRODUCTISE
PROF	PROF
PROFANED	PROFANE
PROFESSES	PROFESS
PROFESSIONALIZED	PROFESSIONALIZE
PROFFERS	PROFFER
PROFILES	PROFILE
PROFITS	PROFIT
PROFOUNDEST	PROFOUND
PROFUNDIS	PROFUNDIS
PROG	PROG
PROGRADED	PROGRADE
PROGRAM	PROGRAM
PROGRAMMES	PROGRAMME
PROGR�S	PROGR�S
PROGRESSES	PROGRESS
PROHIBITS	PROHIBIT
PROJECTS	PROJECT
PROJETS	PROJET
PROLIFERATES	PROLIFERATE
PROLONGS	PROLONG
PROM	PROM
PROMENADE	PROMENADE
PROMISES	PROMISE
PROMOTES	PROMOTE
PROMPTS	PROMPT
PROMULGATED	PROMULGATE
PRONOUN	PRONOUN
PRONOUNCES	PRONOUNCE
PROOFED	PROOF
PROOFREADING	PROOFREAD
PROPS	PROP
PROPAGATES	PROPAGATE
PROPELS	PROPEL
PROPERTIED	PROPERTY
PROPHESIES	PROPHESY
PROPITIATED	PROPITIATE
PROPORTIONS	PROPORTION
PROPOSES	PROPOSE
PROPOSITIONED	PROPOSITION
PROPOUNDS	PROPOUND
PROSCRIBES	PROSCRIBE
PROSE	PROSE
PROSECUTES	PROSECUTE
PROSELYTISE	PROSELYTISE
PROSELYTIZE	PROSELYTIZE
PROSPECTED	PROSPECT
PROSPERS	PROSPER
PROSTITUTED	PROSTITUTE
PROSTRATED	PROSTRATE
PROTECTS	PROTECT
PROTESTS	PROTEST
PROTOTYPING	PROTOTYP
PROTOTYPE	PROTOTYPE
PROTRACTING	PROTRACT
PROTRUDES	PROTRUDE
PROUDEST	PROUD
PROVES	PROVE
PROVIDES	PROVIDE
PROVIDED	PROVIDED
PROVIDING	PROVIDING
PROVISIONED	PROVISION
PROVOCATEUR	PROVOCATEUR
PROVOKES	PROVOKE
PROVOST	PROVOST
PROWLS	PROWL
PROXIED	PROXY
PRUE	PRUE
PRUNED	PRUNE
PRUNUS	PRUNUS
PRYS	PRY
PSD	PSD
PSYCHED	PSYCH
PSYCHE	PSYCHE
PSYCHO	PSYCHO
PSYCHOANALYSE	PSYCHOANALYSE
PT	PT
PU	PU
PUB	PUB
PUBLIC	PUBLIC
PUBLICISES	PUBLICISE
PUBLICIZED	PUBLICIZE
PUBLIQUE	PUBLIQUE
PUBLISHES	PUBLISH
PUCKERS	PUCKER
PUDDLING	PUDDLE
PUEBLO	PUEBLO
PUFFS	PUFF
PUGH	PUGH
PUKE	PUKE
PULLS	PULL
PULMONARIA	PULMONARIA
PULPED	PULP
PULSATE	PULSATE
PULSED	PULSE
PULVERISED	PULVERISE
PULVERIZED	PULVERIZE
PUMMELS	PUMMEL
PUMPS	PUMP
PUNS	PUN
PUNCHES	PUNCH
PUNCHLINE	PUNCHLINE
PUNCHIER	PUNCHY
PUNCTUATES	PUNCTUATE
PUNCTURES	PUNCTURE
PUNISHES	PUNISH
PUNT	PUNT
PUPPED	PUP
PUPATE	PUPATE
PURRING	PUR
PURCHASES	PURCHASE
PUREST	PURE
PURGED	PURGE
PURIFIES	PURIFY
PURLING	PURL
PURLOINED	PURLOIN
PURPORTS	PURPORT
PURPOSES	PURPOSE
PURRS	PURR
PURSES	PURSE
PURSUADED	PURSUADE
PURSUES	PURSUE
PURVEYS	PURVEY
PUS	PUS
PUSHES	PUSH
PUSSYFOOTING	PUSSYFOOT
PUTS	PUT
PUTTS	PUTT
PUTTERING	PUTTER
PUZZLES	PUZZLE
PYRACANTHA	PYRACANTHA
PYRUVATE	PYRUVATE
PYX	PYX
QING	Q
QB	QB
QE	QE
QED	QED
QM	QM
QS	QS
QU	QU
QUA	QUA
QUACK	QUACK
QUADRUPLES	QUADRUPLE
QUAFF	QUAFF
QUAILS	QUAIL
QUAKING	QUAKE
QUAL	QUAL
QUALIFIES	QUALIFY
QUANTIFIES	QUANTIFY
QUANTITATED	QUANTITATE
QUARANTINED	QUARANTINE
QUARRELLED	QUARREL
QUARRIED	QUARRY
QUARTERED	QUARTER
QUASHES	QUASH
QUATRE	QUATRE
QUAVERING	QUAVER
QUE	QUE
QUEASIER	QUEASY
QUEER	QUEER
QUEL	QUEL
QUELLS	QUELL
QUELLE	QUELLE
QUEM	QUEM
QUENCHED	QUENCH
QUERIDA	QUERIDA
QUERIES	QUERY
QUESTED	QUEST
QUESTIONS	QUESTION
QUEUED	QUEUE
QUEX	QUEX
QUI	QUI
QUIBBLE	QUIBBLE
QUICKEST	QUICK
QUICKENS	QUICKEN
QUID	QUID
QUIET	QUIET
QUIETENS	QUIETEN
QUILTING	QUILT
QUINCX	QUINCX
QUINTUPLED	QUINTUPLE
QUIPS	QUIP
QUIRKING	QUIRK
QUIRKIEST	QUIRKY
QUITS	QUIT
QUITE	QUITE
QUIVERS	QUIVER
QUIZZED	QUIZ
QUO	QUO
QUOD	QUOD
QUOI	QUOI
QUOTES	QUOTE
QV	QV
R	R
RA	RA
RABBITTING	RABBIT
RAC	RAC
RACES	RACE
RACECOURSE	RACECOURSE
RACKS	RACK
RACIER	RACY
RAD	RAD
RADIATES	RADIATE
RADICAL	RADICAL
RADICALIZED	RADICALIZE
RADIO	RADIO
RADIOED	RADIOE
RADIOLABELLED	RADIOLABEL
RADIOMETER	RADIOMETE
RAFFLED	RAFFLE
RAFTED	RAFT
RAGGED	RAG
RAGES	RAGE
RAI	RAI
RAIDS	RAID
RAILS	RAIL
RAILROADED	RAILROAD
RAINS	RAIN
RAINCOATED	RAINCOAT
RAISES	RAISE
RAISON	RAISON
RAISONNE	RAISONNE
RAISONN�	RAISONN�
RAKES	RAKE
RALLIES	RALLY
RAMS	RAM
RAMBLES	RAMBLE
RAMESH	RAMESH
RAMIFY	RAMIFY
RAMIZ	RAMIZ
RAMPING	RAMP
RAMPAGE	RAMPAGE
RANDOMISED	RANDOMISE
RANDOMIZED	RANDOMIZE
RANDIEST	RANDY
RANGES	RANGE
RANKS	RANK
RANKLES	RANKLE
RANSACKED	RANSACK
RANSOM	RANSOM
RANSOMED	RANSOME
RANTED	RANT
RANULF	RANULF
RAOUL	RAOUL
RAPS	RAP
RAPES	RAPE
RAREST	RARE
RAREFIED	RAREFY
RASA	RASA
RASPED	RASP
RASPBERRYING	RASPBERRY
RASSEMBLEMENT	RASSEMBLEMENT
RATTED	RAT
RATA	RATA
RATES	RATE
RATH	RATH
RATHBONE	RATHBONE
RATIFIES	RATIFY
RATIONS	RATION
RATIONALISES	RATIONALISE
RATIONALIZED	RATIONALIZE
RATTLES	RATTLE
RAUL	RAUL
RA�L	RA�L
RAUNCHIEST	RAUNCHY
RAVAGED	RAVAGE
RAVES	RAVE
RAVENING	RAVEN
RAVISHED	RAVISH
RAWEST	RAW
RAWLS	RAWL
RAWP	RAWP
RAYED	RAY
RAZED	RAZE
RBGE	RBGE
RCM	RCM
RE	RE
REA	REA
REABSORBED	REABSORB
REACHES	REACH
REACTS	REACT
REACTIVATES	REACTIVATE
READS	READ
READDRESSED	READDRESS
READJUSTS	READJUST
READMITTED	READMIT
READIED	READY
REAFFIRMS	REAFFIRM
REAL	REAL
REALIGNED	REALIGN
REALISES	REALISE
REALIZES	REALIZE
REALLOCATED	REALLOCATE
REANIMATED	REANIMATE
REAPS	REAP
REAPPEARS	REAPPEAR
REAPPLIED	REAPPLY
REAPPOINTED	REAPPOINT
REAPPRAISED	REAPPRAISE
REARS	REAR
REARMED	REARM
REARRANGING	REARRANG
REARRANGES	REARRANGE
REARRESTED	REARREST
REARTICULATED	REARTICULATE
REASONS	REASON
REASSEMBLES	REASSEMBLE
REASSERTS	REASSERT
REASSESSED	REASSESS
REASSIGNED	REASSIGN
REASSUME	REASSUME
REASSURES	REASSURE
REAWAKENED	REAWAKEN
REBALANCING	REBALANCE
REBATING	REBATE
REBEKAH	REBEKAH
REBELS	REBEL
REBLEEDING	REBLEED
REBOOT	REBOOT
REBORN	REBORN
REBOUNDS	REBOUND
REBUFFS	REBUFF
REBUILDS	REBUILD
REBUKES	REBUKE
REBURIED	REBURY
REBUTS	REBUT
REC	REC
RECALCULATES	RECALCULATE
RECALLS	RECALL
RECANTED	RECANT
RECAP	RECAP
RECAPITULATES	RECAPITULATE
RECAPTURES	RECAPTURE
RECASTS	RECAST
RECEDES	RECEDE
RECEIVES	RECEIVE
RECESSED	RECESS
RECHALLENGED	RECHALLENGE
RECHARGES	RECHARGE
RECHECKED	RECHECK
RECHERCHE	RECHERCHE
RECHRISTENED	RECHRISTEN
RECIPROCATES	RECIPROCATE
RECIRCULATED	RECIRCULATE
RECITES	RECITE
RECKONS	RECKON
RECLAIMS	RECLAIM
RECLASSIFIED	RECLASSIFY
RECLINES	RECLINE
RECODE	RECODE
RECOGNISES	RECOGNISE
RECOGNIZES	RECOGNIZE
RECOILS	RECOIL
RECOLLAPSE	RECOLLAPSE
RECOLLECTS	RECOLLECT
RECOLONISED	RECOLONISE
RECOMBINED	RECOMBINE
RECOMMENCES	RECOMMENCE
RECOMMENDS	RECOMMEND
RECOMPENSE	RECOMPENSE
RECOMPILED	RECOMPILE
RECONCILES	RECONCILE
RECONDITIONED	RECONDITION
RECONFIGURED	RECONFIGURE
RECONFIRMED	RECONFIRM
RECONNECTED	RECONNECT
RECONNOITRING	RECONNOITR
RECONNOITRE	RECONNOITRE
RECONQUEST	RECONQU
RECONQUERED	RECONQUER
RECONSIDERS	RECONSIDER
RECONSTITUTES	RECONSTITUTE
RECONSTRUCTS	RECONSTRUCT
RECONVENED	RECONVEN
RECONVENES	RECONVENE
RECONVERTED	RECONVERT
RECONVICTED	RECONVICT
RECORDS	RECORD
RECOUNTS	RECOUNT
RECOUPED	RECOUP
RECOVERS	RECOVER
RECREATED	RECREAT
RECREATES	RECREATE
RECROSS	RECROSS
RECRUITS	RECRUIT
RECTIFIES	RECTIFY
RECUPERATED	RECUPERATE
RECURS	RECUR
RECYCLES	RECYCLE
RED	RED
REDDENS	REDDEN
REDECORATED	REDECORATE
REDEDICATED	REDEDICATE
REDEEMS	REDEEM
REDEFINES	REDEFINE
REDEPLOYED	REDEPLOY
REDEPOSITED	REDEPOSIT
REDESIGNED	REDESIGN
REDESIGNATED	REDESIGNATE
REDEVELOPED	REDEVELOP
REDEVELOPING	REDEVELOPE
REDIRECTS	REDIRECT
REDISCOUNTED	REDISCOUNT
REDISCOVERS	REDISCOVER
REDISTRIBUTES	REDISTRIBUTE
REDO	REDO
REDONE	REDONE
REDOUBLES	REDOUBLE
REDOUND	REDOUND
REDRAFTED	REDRAFT
REDRAWN	REDRAW
REDRESSES	REDRESS
REDSHANK	REDSHANK
REDUCES	REDUCE
REDUCTIO	REDUCTIO
REDUPLICATING	REDUPLICATE
REEBOK	REEBOK
REEFING	REEF
REEKS	REEK
REELS	REEL
REELECTED	REELECT
REENTERED	REENTER
REESTABLISHED	REESTABLISH
REEVALUATE	REEVALUATE
REEXAMINED	REEXAMINE
REF	REF
REFASHIONED	REFASHION
REFERS	REFER
REFEREES	REFEREE
REFERENCES	REFERENCE
REFILLING	REFIL
REFILLED	REFILL
REFINANCED	REFINANCE
REFINES	REFINE
REFINISHED	REFINISH
REFITTED	REFIT
REFIX	REFIX
REFLECTS	REFLECT
REFLOAT	REFLOAT
REFLUXED	REFLUX
REFOCUSED	REFOCUSE
REFOLDING	REFOLD
REFORMS	REFORM
REFORMATTED	REFORMAT
REFORMULATES	REFORMULATE
REFOUNDED	REFOUND
REFRACTS	REFRACT
REFRAINS	REFRAIN
REFRAMED	REFRAME
REFRESHES	REFRESH
REFRIGERATED	REFRIGERATE
REFUELS	REFUEL
REFUNDED	REFUND
REFURBISHED	REFURBISH
REFURNISHED	REFURNISH
REFUSES	REFUSE
REFUTES	REFUTE
REG	REG
REGAINS	REGAIN
REGALES	REGALE
REGARDS	REGARD
REGARDER	REGARDER
REGARDING	REGARDING
REGARDS	REGARDS
REGENERATES	REGENERATE
REGIME	REGIME
R�GIME	R�GIME
REGIMENTED	REGIMENT
REGINA	REGINA
REGISTERS	REGISTER
REGRADED	REGRADE
REGRANTED	REGRANT
REGRESSES	REGRESS
REGRETS	REGRET
REGROUPED	REGROUP
REGROWS	REGROW
REGULARISED	REGULARISE
REGULARIZED	REGULARIZE
REGULATES	REGULATE
REGUM	REGUM
REGURGITATES	REGURGITATE
REHABILITATED	REHABILITATE
REHANG	REHANG
REHEARSES	REHEARSE
REHEATED	REHEAT
REHIRED	REHIRE
REHOMED	REHOME
REHOUSED	REHOUSE
REHYDRATED	REHYDRATE
REIFY	REIFY
REIGNS	REIGN
REIMS	REIM
REIMBURSES	REIMBURSE
REIMPOSED	REIMPOSE
REINED	REIN
REINCARNATED	REINCARNATE
REINCORPORATED	REINCORPORATE
REINFORCES	REINFORCE
REINSERTED	REINSERT
REINSTATES	REINSTATE
REINSURING	REINSURE
REINTEGRATED	REINTEGRATE
REINTERPRETS	REINTERPRET
REINTERPRETED	REINTERPRETE
REINTRODUCES	REINTRODUCE
REINVEST	REINV
REINVENTED	REINVENT
REINVESTED	REINVEST
REINVESTIGATED	REINVESTIGATE
REINVIGORATED	REINVIGORATE
REISSUED	REISSUE
REITERATES	REITERATE
REJECTS	REJECT
REJIG	REJIG
REJOICES	REJOICE
REJOINS	REJOIN
REJUVENATED	REJUVENATE
REKINDLES	REKINDLE
REL	REL
RELABELLING	RELABEL
RELAPSES	RELAPSE
RELATES	RELATE
RELATIVIZE	RELATIVIZE
RELAUNCHES	RELAUNCH
RELAXES	RELAX
RELAYS	RELAY
RELEARNED	RELEARN
RELEASES	RELEASE
RELEGATES	RELEGATE
RELENTS	RELENT
RELETTING	RELET
RELIEVES	RELIEVE
RELIGHT	RELIGHT
RELINQUISHES	RELINQUISH
RELISHES	RELISH
RELISTED	RELIST
RELIVES	RELIVE
RELOADED	RELOAD
RELOCATES	RELOCATE
RELOCKED	RELOCK
RELIES	RELY
REMMED	REM
REMAINS	REMAIN
REMAINDERED	REMAINDER
REMADE	REMAKE
REMANDED	REMAND
REMARKS	REMARK
REMARRIES	REMARRY
REMASTERED	REMASTER
REME	REME
REMEDIES	REMEDY
REMEM	REMEM
REMEMBERS	REMEMBER
REMI	REMI
REMINDS	REMIND
REMINISCES	REMINISCE
REMITS	REMIT
REMIXED	REMIX
REMO	REMO
REMODELLED	REMODEL
REMONSTRATED	REMONSTRATE
REMORTGAGE	REMORTGAGE
REMOTEST	REMOTE
REMOULDED	REMOULD
REMOUNTED	REMOUNT
REMOVES	REMOVE
REMUNERATED	REMUNERATE
REN	REN
RENAMES	RENAME
RENATIONALISE	RENATIONALISE
REND	REND
RENDERS	RENDER
RENDEZVOUS	RENDEZVOUS
RENEGED	RENEGE
RENEGOTIATED	RENEGOTIATE
RENEWS	RENEW
RENOUNCES	RENOUNCE
RENOVATED	RENOVATE
RENTS	RENT
RENUMBERED	RENUMBER
REOCCUPIED	REOCCUPY
REOCCUR	REOCCUR
REOFFENDED	REOFFEND
REOPENS	REOPEN
REORDERED	REORDER
REORGANISES	REORGANISE
REORGANIZED	REORGANIZE
REORIENTING	REORIENT
REORIENTATED	REORIENTATE
REP	REP
REPACKED	REPACK
REPACKAGED	REPACKAGE
REPAINTED	REPAINT
REPAIRS	REPAIR
REPASS	REPASS
REPATRIATED	REPATRIATE
REPAVED	REPAVE
REPAYS	REPAY
REPEALS	REPEAL
REPEATS	REPEAT
REPELS	REPEL
REPENS	REPEN
REPENTS	REPENT
REPHRASED	REPHRASE
REPLACES	REPLACE
REPLANNED	REPLAN
REPLANTED	REPLANT
REPLASTERING	REPLASTER
REPLAYS	REPLAY
REPLENISHES	REPLENISH
REPLICATES	REPLICATE
REPLIES	REPLY
REPO	REPO
REPOINTING	REPOINT
REPOPULATED	REPOPULATE
REPORTS	REPORT
REPOSED	REPOSE
REPOSITIONED	REPOSITION
REPOSSESSED	REPOSSESS
REPOTTED	REPOT
REPRESENTS	REPRESENT
REPRESSES	REPRESS
REPRIEVED	REPRIEVE
REPRIMANDS	REPRIMAND
REPRINTED	REPRINT
REPRISE	REPRISE
REPROACHES	REPROACH
REPROCESSED	REPROCESS
REPRODUCES	REPRODUCE
REPROGRAMMED	REPROGRAM
REPROVES	REPROVE
R�PUBLIQUE	R�PUBLIQUE
REPUBLISHES	REPUBLISH
REPUDIATES	REPUDIATE
REPULSES	REPULSE
REPURCHASED	REPURCHASE
REPUTED	REPUTE
REQ	REQ
REQUESTS	REQUEST
REQUIRES	REQUIRE
REQUISITIONS	REQUISITION
REREAD	REREAD
REROUTED	REROUT
RERUM	RERUM
RERUN	RERUN
RES	RES
RESCALING	RESCALE
RESCHEDULED	RESCHEDULE
RESCINDED	RESCIND
RESCUES	RESCUE
RESEALED	RESEAL
RESEARCHES	RESEARCH
RESECTED	RESECT
RESEEDED	RESEED
RESELECTED	RESELECT
RESELLS	RESELL
RESEMBLES	RESEMBLE
RESENTS	RESENT
RESERVES	RESERVE
RESETS	RESET
RESETTLED	RESETTLE
RESHAPES	RESHAPE
RESHUFFLED	RESHUFFLE
RESIDES	RESIDE
RESIGNS	RESIGN
RESISTS	RESIST
RESISTANCE	RESISTANCE
R�SISTANCE	R�SISTANCE
RESITED	RESIT
RESIZED	RESIZE
RESOLD	RESOLD
RESOLVES	RESOLVE
RESONATES	RESONATE
RESORTS	RESORT
RESOUNDS	RESOUND
RESOURCED	RESOURCE
RESPECTS	RESPECT
RESPECTING	RESPECTING
RESPIRE	RESPIRE
RESPITE	RESPITE
RESPONDS	RESPOND
RESPRAYED	RESPRAY
RESTS	REST
RESTARTS	RESTART
RESTATES	RESTATE
RESTOCK	RESTOCK
RESTORES	RESTORE
RESTRAINS	RESTRAIN
RESTRICTS	RESTRICT
RESTRUCTURES	RESTRUCTURE
RESTYLED	RESTYLE
RESUBMITTED	RESUBMIT
RESULTS	RESULT
RESUMES	RESUME
R�SUM�	R�SUM�
RESUPPLYING	RESUPPLY
RESURFACES	RESURFACE
RESURRECTS	RESURRECT
RESURVEYED	RESURVEY
RESUSCITATED	RESUSCITATE
RESUSPENDED	RESUSPEND
RET	RET
RETAILS	RETAIL
RETAINS	RETAIN
RETAKES	RETAKE
RETAKEN	RETAKEN
RETALIATES	RETALIATE
RETARDS	RETARD
RETCH	RETCH
RETE	RETE
RETELLS	RETELL
RETESTED	RETEST
RETHINK	RETHINK
RETHOUGHT	RETHOUGHT
RETIRES	RETIRE
RETITLED	RETITLE
RETIX	RETIX
RETOLD	RETOLD
RETOOK	RETOOK
RETORTS	RETORT
RETOUCHED	RETOUCH
RETRACES	RETRACE
RETRACTS	RETRACT
RETRAINED	RETRAIN
RETREATS	RETREAT
RETRENCH	RETRENCH
RETRIEVES	RETRIEVE
RETROFIT	RETROFIT
RETRIED	RETRY
RETUNED	RETUNE
RETURNS	RETURN
RETYING	RETY
RETYPED	RETYP
REUNIFIED	REUNIFY
R�UNION	R�UNION
REUNITING	REUNIT
REUNITES	REUNITE
REUSED	REUSE
REUSS	REUSS
REVVED	REV
REVALUED	REVALUE
REVAMPS	REVAMP
REVEALS	REVEAL
REVELS	REVEL
REVENGED	REVENGE
REVERED	REVER
REVERBERATES	REVERBERATE
REVERES	REVERE
REVERENCED	REVERENCE
REVERSES	REVERSE
REVERTS	REVERT
REVIEWS	REVIEW
REVILED	REVILE
REVISES	REVISE
REVISITS	REVISIT
REVITALISED	REVITALISE
REVITALIZED	REVITALIZE
REVIVES	REVIVE
REVIVIFIED	REVIVIFY
REVOIR	REVOIR
REVOKES	REVOKE
REVOLTS	REVOLT
REVOLUCIONARIA	REVOLUCIONARIA
R�VOLUTION	R�VOLUTION
REVOLUTIONISED	REVOLUTIONISE
REVOLUTIONIZED	REVOLUTIONIZE
REVOLVES	REVOLVE
REVUE	REVUE
REWARDS	REWARD
REWINDS	REWIND
REWIRED	REWIRE
REWORDING	REWORD
REWORKS	REWORK
REWOUND	REWOUND
REWRITING	REWRIT
REWRITES	REWRITE
REWROTE	REWROTE
REX	REX
REYBURN	REYBURN
RH	RH
RHYMED	RHYM
RHYMES	RHYME
RI	RI
RIBBING	RIB
RICH	RICH
RICHE	RICHE
RICHES	RICHES
RICOCHETED	RICOCHET
RICOCHETING	RICOCHETE
RIDS	RID
RIDDLED	RIDDLE
RIDES	RIDE
RIDICULES	RIDICULE
RIEN	RIEN
RIFAT	RIFAT
RIFFS	RIFF
RIFFLE	RIFFLE
RIFLED	RIFLE
RIFTING	RIFT
RIGS	RIG
RIGG	RIGG
RIGHTS	RIGHT
RIGHTSIZING	RIGHTSIZE
RIGHTWINGER	RIGHTWING
RIGOR	RIGOR
RIGUEUR	RIGUEUR
RILES	RILE
RIMMED	RIM
RIMED	RIME
RINCEWIND	RINCEWIND
RINGS	RING
RINGED	RINGE
RINSES	RINSE
RIOTS	RIOT
RIPS	RIP
RIPEST	RIPE
RIPENS	RIPEN
RIPOSTED	RIPOST
RIPPLED	RIPPLE
RISES	RISE
RISKS	RISK
RISKIEST	RISKY
RIVALS	RIVAL
RIVE	RIVE
RIVETS	RIVET
RNASE	RNASE
RO	RO
ROA	ROA
ROAMS	ROAM
ROARS	ROAR
ROASTS	ROAST
ROBS	ROB
ROBED	ROBE
ROBOCOP	ROBOCOP
ROCA	ROCA
ROCKS	ROCK
ROCKETS	ROCKET
ROCKIER	ROCKY
RODDING	ROD
RODET	RODET
ROGERED	ROGER
ROI	ROI
ROILING	ROIL
ROJA	ROJA
ROLLS	ROLL
ROLLERSKATE	ROLLERSKATE
ROM	ROM
ROMA	ROMA
ROMAN	ROMAN
ROMANA	ROMANA
ROMANCING	ROMANCE
ROMANCIERS	ROMANCIERS
ROMANTICISE	ROMANTICISE
ROMANTICIZED	ROMANTICIZE
ROMPS	ROMP
ROO	ROO
ROOFED	ROOF
ROOMING	ROOM
ROOMIER	ROOMY
ROOST	ROOST
ROOTS	ROOT
ROPED	ROPE
ROSING	ROSE
ROS�	ROS�
ROSEHAUGH	ROSEHAUGH
ROSENKAVALIER	ROSENKAVALIER
ROSSIGNOL	ROSSIGNOL
ROSTERED	ROSTER
ROSIEST	ROSY
ROTS	ROT
ROTATES	ROTATE
ROTHERHITHE	ROTHERHITHE
ROU	ROU
ROUGED	ROUGE
ROUGET	ROUGET
ROUGHS	ROUGH
ROUGHENED	ROUGHEN
ROUNDS	ROUND
ROUSES	ROUSE
ROUTED	ROUT
ROUTES	ROUTE
ROVES	ROVE
ROWS	ROW
ROWDIER	ROWDY
ROY	ROY
ROYALE	ROYALE
RS	RS
RU	RU
RUBS	RUB
RUBBISHED	RUBBISH
RUBUS	RUBUS
RUCKED	RUCK
RUDEST	RUDE
RUDOLF	RUDOLF
RUES	RUE
RUETHER	RUETHER
RUFFLES	RUFFLE
RUINS	RUIN
RUINED	RUINE
RULES	RULE
RUMBLES	RUMBLE
RUMINATES	RUMINATE
RUMMAGES	RUMMAGE
RUMOURED	RUMOUR
RUMPLED	RUMPLE
RUNS	RUN
RUNNIER	RUNNY
RUPTURES	RUPTURE
RUSHES	RUSH
RUSTS	RUST
RUSTLED	RUSTLE
RUTTING	RUT
RUUD	RUUD
RIVEN	RVE
S	S
SA	SA
SABAH	SABAH
SABOTAGES	SABOTAGE
SAC	SAC
SACKS	SACK
SACRE	SACRE
SACRIFICES	SACRIFICE
SADDEST	SAD
SADBERGE	SADBERGE
SADDENS	SADDEN
SADDLES	SADDLE
SAED	SAE
SAFE	SAFE
SAFEGUARDS	SAFEGUARD
SAFETY	SAFETY
SAGS	SAG
SAHIB	SAHIB
SAI	SAI
SAILS	SAIL
SAINT	SAINT
SAINTE	SAINTE
SAIS	SAIS
SAL	SAL
SALA	SALA
SALADE	SALADE
SALIM	SALIM
SALIVATE	SALIVATE
SALIX	SALIX
SALLE	SALLE
SALLIES	SALLY
SALMETEROL	SALMETEROL
SALON	SALON
SALSIFY	SALSIFY
SALTED	SALT
SALTBURN	SALTBURN
SALTWATER	SALTWATE
SALTIER	SALTY
SALUTES	SALUTE
SALVAGED	SALVAGE
SALVATORE	SALVATORE
SALVES	SALVE
SALVIA	SALVIA
SAM	SAM
SAMPLES	SAMPLE
SAMSUNG	SAMSUNG
SAN	SAN
SANCTIFIED	SANCTIFY
SANCTIONS	SANCTION
SANCTUS	SANCTUS
SANDED	SAND
SANDBAGGED	SANDBAG
SANDPAPERING	SANDPAPER
SANDTEX	SANDTEX
SANDWICHED	SANDWICH
SANDIER	SANDY
SANEST	SANE
SANITAIRE	SANITAIRE
SANITISE	SANITISE
SANS	SANS
SAPS	SAP
SAPIENS	SAPIENS
SAR	SAR
SASHAYING	SASHAY
SAT	SAT
SATED	SATE
SATIATED	SATIATE
SATIRISES	SATIRISE
SATIRIZES	SATIRIZE
SATISFIES	SATISFY
SATURATES	SATURATE
SAUCED	SAUCE
SAUNTERS	SAUNTER
SAUTE	SAUTE
SAUT�	SAUT�
SAVAGED	SAVAGE
SAVANNAH	SAVANNAH
SAVES	SAVE
SAVING	SAVING
SAVOIR	SAVOIR
SAVOURS	SAVOUR
SAWN	SAW
SAYS	SAY
SC	SC
SCA	SCA
SCABIOUS	SCABIOUS
SCALDED	SCALD
SCALES	SCALE
SCALPED	SCALP
SCAMPERS	SCAMPER
SCANS	SCAN
SCANDALISE	SCANDALISE
SCANDALIZED	SCANDALIZE
SCANT	SCANT
SCAPEGOAT	SCAPEGOAT
SCARS	SCAR
SCARCEST	SCARCE
SCARES	SCARE
SCAREMONGERING	SCAREMONGER
SCARFED	SCARF
SCARIFIED	SCARIFY
SCARPERED	SCARPER
SCARIEST	SCARY
SCATHACH	SCATHACH
SCATTERS	SCATTER
SCAVENGING	SCAVENG
SCAVENGES	SCAVENGE
SCE	SCE
SC�NES	SC�NES
SCENTS	SCENT
SCH	SCH
SCHEDULED	SCHEDULE
SCHEMED	SCHEME
SCHOOLS	SCHOOL
SCHOOLMASTERING	SCHOOLMASTER
SCHR�DINGER	SCHR�DINGER
SCHROEDER	SCHROED
SCIAF	SCIAF
SCISSOR	SCISSOR
SCISSORED	SCISSORE
SCO	SCO
SCOFFS	SCOFF
SCOLDS	SCOLD
SCOOPS	SCOOP
SCOOT	SCOOT
SCORCHES	SCORCH
SCORES	SCORE
SCORNS	SCORN
SCOT	SCOT
SCOTCHED	SCOTCH
SCOURS	SCOUR
SCOURGED	SCOURGE
SCOUTS	SCOUT
SCOWLS	SCOWL
SCR	SCR
SCRABBLED	SCRABBLE
SCRAM	SCRAM
SCRAMBLES	SCRAMBLE
SCRAPPED	SCRAP
SCRAPES	SCRAPE
SCRATCHES	SCRATCH
SCRAWLS	SCRAWL
SCREAMS	SCREAM
SCREECHES	SCREECH
SCREENS	SCREEN
SCREWS	SCREW
SCRIBBLES	SCRIBBLE
SCRIBE	SCRIBE
SCRIMPED	SCRIMP
SCRIPTED	SCRIPT
SCROLLED	SCROL
SCROLLS	SCROLL
SCROOGE	SCROOGE
SCROUNGING	SCROUNG
SCROUNGED	SCROUNGE
SCRUBS	SCRUB
SCRUFFIEST	SCRUFFY
SCRUMMAGING	SCRUMMAGE
SCRUNCHED	SCRUNCH
SCRUPLES	SCRUPLE
SCRUTINISES	SCRUTINISE
SCRUTINIZES	SCRUTINIZE
SCSE	SCSE
SCUDDING	SCUD
SCUFFED	SCUFF
SCUFFLING	SCUFFLE
SCULLS	SCULL
SCULPTED	SCULPT
SCULPTURED	SCULPTURE
SCUM	SCUM
SCUPPERS	SCUPPER
SCURRIES	SCURRY
SCUTTERED	SCUTTER
SCUTTLES	SCUTTLE
SCYTHING	SCYTH
SCYTHED	SCYTHE
SES	SE
SEALS	SEAL
SEAMED	SEAM
SEAMIER	SEAMY
SEARED	SEAR
SEARCHES	SEARCH
SEASONED	SEASON
SEATS	SEAT
SEC	SEC
SECEDED	SECEDE
SECLUDED	SECLUDE
SECONDS	SECOND
SECRETES	SECRETE
SECTS	SECT
SECTIONS	SECTION
SECURES	SECURE
SEDATED	SEDATE
SEDE	SEDE
SEDERUNT	SEDERUNT
SEDUCES	SEDUCE
SEDUM	SEDUM
SEES	SEE
SEEDS	SEED
SEEDIEST	SEEDY
SEEING	SEEING
SEEKS	SEEK
SEEMS	SEEM
SEEPS	SEEP
SEETHES	SEETHE
SEGMENTED	SEGMENT
SEGREGATES	SEGREGATE
SEGUED	SEGUE
SEI	SEI
SEIGNEUR	SEIGNEUR
SEIN	SEIN
SEINE	SEINE
SEISED	SEISE
SEIZES	SEIZE
SEL	SEL
SELECTS	SELECT
SELLS	SELL
SELLOTAPED	SELLOTAPE
SEMAPHORING	SEMAPHORE
SEMPER	SEMPER
SEN	SEN
SENDS	SEND
SE�OR	SE�OR
SE�ORA	SE�ORA
SENS	SENS
SENSATIONALISE	SENSATIONALISE
SENSES	SENSE
SENSITISED	SENSITISE
SENSITIZED	SENSITIZE
SENTENCES	SENTENCE
SEP	SEP
SEPARATES	SEPARATE
SEPERATE	SEPERATE
SEPT	SEPT
SEQ	SEQ
SEQUENCED	SEQUENCE
SEQUESTERED	SEQUESTER
SEQUESTRATED	SEQUESTRATE
SEQUINNED	SEQUIN
SER	SER
SERA	SERA
SERENADED	SERENADE
SERIALLED	SERIAL
SERIALISED	SERIALISE
SERIALIZED	SERIALIZE
SERIE	SERIE
SERIOUS	SERIOUS
SEROCONVERTED	SEROCONVERT
SERV	SERV
SERVES	SERVE
SERVI	SERVI
SERVICES	SERVICE
SES	SES
SETS	SET
SEETHING	SETHE
SETTLES	SETTLE
SEV	SEV
SEVEN	SEVEN
SEVENS	SEVENS
SEVENTEEN	SEVENTEEN
SEVENTEENTH	SEVENTEENTH
SEVENTH	SEVENTH
SEVENTHS	SEVENTHS
SEVENTIES	SEVENTIES
SEVENTIETH	SEVENTIETH
SEVENTY	SEVENTY
SEVERS	SEVER
SEVEREST	SEVERE
SEWS	SEW
SEXED	SEX
SEXIEST	SEXY
SEYED	SEY
SEZ	SEZ
SH	SH
SHA	SHA
SHABBIER	SHABBY
SHACKED	SHACK
SHACKLES	SHACKLE
SHADES	SHADE
SHADOWS	SHADOW
SHADWELL	SHADWELL
SHADIEST	SHADY
SHAFTED	SHAFT
SHAGGED	SHAG
SHAKES	SHAKE
SHAKIEST	SHAKY
SHALLOWED	SHALLOW
SHAMMING	SHAM
SHAMBLE	SHAMBLE
SHAMES	SHAME
SHAMPOO	SHAMPOO
SHAMPOOED	SHAMPOOE
SHAPES	SHAPE
SHARES	SHARE
SHARPEST	SHARPE
SHARPENS	SHARPEN
SHAT	SHAT
SHATTERS	SHATTER
SHAVES	SHAVE
SHAWN	SHAWN
SHE	SHE
SHORN	SHEAR
SHEATHED	SHEATHE
SHEDS	SHED
SHEENED	SHEEN
SHEERED	SHEER
SHEETED	SHEET
SHELAGH	SHELAGH
SHELLED	SHELL
SHELTERS	SHELTER
SHELVES	SHELVE
SHEN	SHEN
SHEPHERDED	SHEPHERD
SHEATHING	SHETHE
SHEWS	SHEW
SHH	SHH
SHHH	SHHH
SHI	SHI
SHIBBOLETH	SHIBBOLETH
SHIELDS	SHIELD
SHIFTS	SHIFT
SHIFTWORKING	SHIFTWORK
SHILS	SHIL
SHIMMERS	SHIMMER
SHIMMYING	SHIMMY
SHINNING	SHIN
SHINES	SHINE
SHINIER	SHINY
SHIPS	SHIP
SHIPBUILDERS	SHIPBUILDER
SHIPPENS	SHIPPEN
SHIPWRECKED	SHIPWRECK
SHIRKED	SHIRK
SHITS	SHIT
SHIVERS	SHIVER
SHO	SHO
SHOAL	SHOAL
SHOCKS	SHOCK
SHOD	SHOE
SHOEHORN	SHOEHORN
SHOEMAKING	SHOEMAKE
SHOOING	SHOO
SHOOED	SHOOE
SHOOTS	SHOOT
SHOPS	SHOP
SHOPLIFT	SHOPLIFT
SHORED	SHORE
SHORT	SHORT
SHORTENS	SHORTEN
SHORTLISTED	SHORTLIST
SHORTLIVED	SHORTLIVE
SHOTTERMILL	SHOTTERMILL
SHOU	SHOU
SHOULD	SHOULD
SHOULDERED	SHOULDER
SHOUTS	SHOUT
SHOVES	SHOVE
SHOVELLED	SHOVEL
SHOWS	SHOW
SHOWCASED	SHOWCASE
SHOWERS	SHOWER
SHOWGROUND	SHOWGROUND
SHREDS	SHRED
SHREEVES	SHREEVE
SHREWDEST	SHREWD
SHRIEKS	SHRIEK
SHRILLING	SHRIL
SHRILLS	SHRILL
SHRINKS	SHRINK
SHRIVELS	SHRIVEL
SHROUDS	SHROUD
SHRUGS	SHRUG
SHRIVEN	SHRVE
SHU	SHU
SHUDDERS	SHUDDER
SHUFFLES	SHUFFLE
SHUG	SHUG
SHUNS	SHUN
SHUNTS	SHUNT
SHUSHED	SHUSH
SHUTS	SHUT
SHUTTLING	SHUTTLE
SHIES	SHY
SI	SI
S�	S�
S�	S�
SICKED	SICK
SICKENED	SICKEN
SICKLING	SICKLE
SIDES	SIDE
SIDELINED	SIDELINE
SIDESLIP	SIDESLIP
SIDESTEPS	SIDESTEP
SIDETRACKED	SIDETRACK
SIDLES	SIDLE
SIE	SIE
SI�CLE	SI�CLE
SIEG	SIEG
SIEVED	SIEVE
SIFTS	SIFT
SIG	SIG
SIGHS	SIGH
SIGHTED	SIGHT
SIGHTSEEING	SIGHTSEE
SIGNS	SIGN
SIGNALS	SIGNAL
SIGNIFIES	SIGNIFY
SIGNORA	SIGNORA
SIGNORE	SIGNORE
SIGNPOSTS	SIGNPOST
SIL	SIL
SILENCES	SILENCE
SILHOUETTED	SILHOUETTE
SILICONED	SILICON
SILLIEST	SILLY
SILTS	SILT
SILVERED	SILVER
SIMS	SIM
SIMMERS	SIMMER
SIMPER	SIMPER
SIMPLE	SIMPLE
SIMPLIFIES	SIMPLIFY
SIMULATES	SIMULATE
SINNED	SIN
SINCE	SINCE
SINCEREST	SINCERE
SINE	SINE
SINEAD	SINEAD
SINFONIA	SINFONIA
SINGS	SING
SINGED	SINGE
SINGLES	SINGLE
SINGLEHANDED	SINGLEHAND
SINGSPIEL	SINGSPIEL
SINKS	SINK
SINN	SINN
SIPS	SIP
SIPHONED	SIPHON
SIRED	SIRE
SIS	SIS
SITS	SIT
SITED	SITE
SITU	SITU
SITUATES	SITUATE
SIX	SIX
SIXES	SIXES
SIXT	SIXT
SIXTEEN	SIXTEEN
SIXTEENTH	SIXTEENTH
SIXTH	SIXTH
SIXTHS	SIXTHS
SIXTIES	SIXTIES
SIXTIETH	SIXTIETH
SIXTY	SIXTY
SIZES	SIZE
SIZZLE	SIZZLE
SK	SK
SKATES	SKATE
SKATEBOARDING	SKATEBOARD
SKETCHES	SKETCH
SKETCHIEST	SKETCHY
SKEWS	SKEW
SKEWERED	SKEWER
SKIS	SKI
SKIDS	SKID
SKILLSTART	SKILLSTART
SKIMS	SKIM
SKIMPED	SKIMP
SKIMPIEST	SKIMPY
SKINS	SKIN
SKINNIER	SKINNY
SKIPS	SKIP
SKIPPERED	SKIPPER
SKIRLED	SKIRL
SKIRMISH	SKIRMISH
SKIRTS	SKIRT
SKITTERING	SKITTER
SKITTLED	SKITTLE
SKIVE	SKIVE
SKIVVYING	SKIVVY
SKULKS	SKULK
SKIED	SKY
SKYDIVING	SKYDIVE
SKYLARKING	SKYLARK
SKYWALK	SKYWALK
SL	SL
SLACK	SLACK
SLACKENS	SLACKEN
SLAGS	SLAG
SLAKED	SLAKE
SLAMS	SLAM
SLANDERED	SLANDER
SLANGING	SLANG
SLANTED	SLANT
SLAPS	SLAP
SLASHES	SLASH
SLATES	SLATE
SLAUGHTERS	SLAUGHTER
SLAVES	SLAVE
SLAVERING	SLAVER
SLAYS	SLAY
SLED	SLE
SLEAZIEST	SLEAZY
SLEDGE	SLEDGE
SLEEKING	SLEEK
SLEEPS	SLEEP
SLEEPWALKED	SLEEPWALK
SLEEPIER	SLEEPY
SLEET	SLEET
SLEEVED	SLEEVE
SLENDEREST	SLENDERE
SLEWS	SLEW
SLI	SLI
SLICES	SLICE
SLICKED	SLICK
SLIDES	SLIDE
SLIGHTED	SLIGHT
SLIMS	SLIM
SLINGS	SLING
SLINKS	SLINK
SLIPS	SLIP
SLIPPERED	SLIPPER
SLIPSTITCH	SLIPSTITCH
SLIPSTREAMED	SLIPSTREAM
SLITS	SLIT
SLITHERS	SLITHER
SLOBBERED	SLOBBER
SLOG	SLOG
SLOPPED	SLOP
SLOPES	SLOPE
SLOSHES	SLOSH
SLOTS	SLOT
SLOUCHES	SLOUCH
SLOUGHED	SLOUGH
SLOWS	SLOW
SLUDGE	SLUDGE
SLUGGED	SLUG
SLUICING	SLUICE
SLUM	SLUM
SLUMBERS	SLUMBER
SLUMPS	SLUMP
SLUNK	SLUNK
SLURS	SLUR
SLURPING	SLURP
SLUSH	SLUSH
SM	SM
SMA	SMA
SMACKS	SMACK
SMALLEST	SMALL
SMALLHOLDING	SMALLHOLD
SMARTS	SMART
SMARTENS	SMARTEN
SMASHES	SMASH
SMEARS	SMEAR
SMELLS	SMELL
SMELLIEST	SMELLY
SMELTED	SMELT
SMILES	SMILE
SMIRKS	SMIRK
SMITES	SMITE
SMOG	SMOG
SMOKES	SMOKE
SMOOCHING	SMOOCH
SMOOTHS	SMOOTH
SMOTHERS	SMOTHER
SMOULDERED	SMOULDER
SMITHING	SMTHE
SMUDGED	SMUDGE
SMUGGLED	SMUGGLE
SN	SN
SNA	SNA
SNACK	SNACK
SNAFFLED	SNAFFLE
SNAGGED	SNAG
SNAKES	SNAKE
SNAPS	SNAP
SNAPPIER	SNAPPY
SNARES	SNARE
SNARLS	SNARL
SNATCHES	SNATCH
SNEAKS	SNEAK
SNEERS	SNEER
SNEEZES	SNEEZE
SNICKED	SNICK
SNICKERING	SNICKER
SNIFFS	SNIFF
SNIFFLE	SNIFFLE
SNIGGERS	SNIGGER
SNIPS	SNIP
SNIPED	SNIPE
SNIVELLING	SNIVEL
SNOBS	SNOB
SNODGRASS	SNODGRASS
SNOGGED	SNOG
SNOOK	SNOOK
SNOOKERED	SNOOKER
SNOOP	SNOOP
SNOOZES	SNOOZE
SNORES	SNORE
SNORKEL	SNORKEL
SNORTS	SNORT
SNOWS	SNOW
SNOWBALLED	SNOWBAL
SNOWBALL	SNOWBALL
SNUBS	SNUB
SNUCK	SNUCK
SNUFFS	SNUFF
SNUFFLING	SNUFFLE
SNUGGED	SNUG
SNUGGLES	SNUGGLE
SNYDER	SNYDER
SO	SO
SOAKS	SOAK
SOAPS	SOAP
SOARS	SOAR
SOBS	SOB
SOBERS	SOBER
SOC	SOC
SOCIAL	SOCIAL
SOCIALISED	SOCIALISE
SOCIALIST	SOCIALIST
SOCIALISTA	SOCIALISTA
SOCIALISTE	SOCIALISTE
SOCIALIZED	SOCIALIZE
SOCIETE	SOCIETE
SOCI�T�	SOCI�T�
SOCKED	SOCK
SOD	SOD
SOFTEST	SOFT
SOFTENS	SOFTEN
SOILS	SOIL
SOIR	SOIR
SOL	SOL
SOLACE	SOLACE
SOLDERED	SOLDER
SOLDIERED	SOLDIER
SOLED	SOLE
SOLICITS	SOLICIT
SOLIDIFIES	SOLIDIFY
SOLIPSIST	SOLIPSIST
SOLOING	SOLO
SOLOED	SOLOE
SOLVES	SOLVE
SOM	SOM
SOME	SOME
SOMEBODY	SOMEBODY
SOMEONE	SOMEONE
SOMERSAULT	SOMERSAULT
SOMETHING	SOMETHING
SOMEWHAT	SOMEWHAT
SONNING	SON
SONICATED	SONICATE
SONNE	SONNE
SOON	SOON
SOOTHES	SOOTHE
SOP	SOP
SOPRANO	SOPRANO
SOPRINTENDENZA	SOPRINTENDENZA
SOR	SOR
SORER	SORE
SORRIEST	SORRY
SORTS	SORT
SOOTHING	SOTHE
SOTTO	SOTTO
SOU	SOU
SOUGHING	SOUGH
SOUHAIS	SOUHAIS
SOUNDS	SOUND
SOUNDCHECK	SOUNDCHECK
SOUNDPROOFED	SOUNDPROOF
SOUP�ON	SOUP�ON
SOURS	SOUR
SOURCED	SOURCE
SOUS	SOUS
SOUVENIR	SOUVENIR
SOWS	SOW
SOZIALDEMOKRATISCHE	SOZIALDEMOKRATISCHE
SP	SP
SPA	SPA
SPACED	SPACE
SPAG	SPAG
SPAGHETTI	SPAGHETTI
SPAKE	SPAKE
SPANS	SPAN
SPANGLED	SPANGLE
SPANKED	SPANK
SPARRED	SPAR
SPARES	SPARE
SPARKS	SPARK
SPARKLES	SPARKLE
SPARSER	SPARSE
SPASM	SPASM
SPATTERED	SPATTER
SPAWNS	SPAWN
SPAYED	SPAY
SPE	SPE
SPEA	SPEA
SPEAKS	SPEAK
SPEARS	SPEAR
SPEARHEADS	SPEARHEAD
SPEC	SPEC
SPECIALISES	SPECIALISE
SPECIALIX	SPECIALIX
SPECIALIZES	SPECIALIZE
SPECIFIES	SPECIFY
SPECKLING	SPECKLE
SPECRATE	SPECRATE
SPECT	SPECT
SPECTACLED	SPECTACLE
SPECTATING	SPECTATE
SPECULATES	SPECULATE
SPEECHREAD	SPEECHREAD
SPEEDS	SPEED
SPEEDIEST	SPEEDY
SPELLS	SPELL
SPELLBINDING	SPELLBIND
SPENCER	SPENCER
SPENDS	SPEND
SPEWS	SPEW
SPEYHAWK	SPEYHAWK
SPHINCTER	SPHINCT
SPI	SPI
SPICES	SPICE
SPICIER	SPICY
SPIDERGLASS	SPIDERGLASS
SPIDEX	SPIDEX
SPIKED	SPIKE
SPILLS	SPILL
SPILLOVERS	SPILLOVER
SPINS	SPIN
SPINA	SPINA
SPINDLES	SPINDLE
SPIRALS	SPIRAL
SPIRITED	SPIRIT
SPIRITU	SPIRITU
SPITS	SPIT
SPITE	SPITE
SPLASHES	SPLASH
SPLAT	SPLAT
SPLATTERED	SPLATTER
SPLAYS	SPLAY
SPLICED	SPLICE
SPLINTERED	SPLINTER
SPLITS	SPLIT
SPLURGE	SPLURGE
SPLUTTERS	SPLUTTER
SPO	SPO
SP�	SP�
SPOILS	SPOIL
SPONGING	SPONG
SPONGED	SPONGE
SPONSORS	SPONSOR
SPOOFING	SPOOF
SPOOKED	SPOOK
SPOOLED	SPOOL
SPOONED	SPOON
SPORES	SPORE
SPORTS	SPORT
SPORTIER	SPORTY
SPOSE	SPOSE
SPOTS	SPOT
SPOTLIGHTS	SPOTLIGHT
SPOUTS	SPOUT
SPRAINED	SPRAIN
SPRAWLS	SPRAWL
SPRAYS	SPRAY
SPREADS	SPREAD
SPREADEAGLE	SPREADEAGLE
SPRIGGED	SPRIG
SPRINGS	SPRING
SPRINKLES	SPRINKLE
SPRINTS	SPRINT
SPROUTS	SPROUT
SPRUCED	SPRUCE
SPUMANTE	SPUMANTE
SPUNK	SPUNK
SPURS	SPUR
SPURNS	SPURN
SPURTS	SPURT
SPUTTER	SPUTTER
SPIES	SPY
SQUABBLES	SQUABBLE
SQUANDERS	SQUANDER
SQUARER	SQUAR
SQUARES	SQUARE
SQUASHES	SQUASH
SQUATS	SQUAT
SQUAWK	SQUAWK
SQUEAKS	SQUEAK
SQUEAL	SQUEAL
SQUEEZES	SQUEEZE
SQUELCHED	SQUELCH
SQUIG	SQUIG
SQUINTS	SQUINT
SQUIRMS	SQUIRM
SQUIRRELLING	SQUIRREL
SQUIRTS	SQUIRT
SQUISHED	SQUISH
SR	SR
SS	SS
SSH	SSH
SSHH	SSHH
ST	ST
STA	STA
STABS	STAB
STABILISES	STABILISE
STABILIZES	STABILIZE
STABLED	STABLE
STACKS	STACK
STAFFS	STAFF
STAGES	STAGE
STAGGERS	STAGGER
STAGNATED	STAGNATE
STAIDER	STAID
STAINS	STAIN
STAKES	STAKE
STALED	STALE
STALKS	STALK
STALLS	STALL
STAMMERS	STAMMER
STAMPS	STAMP
STAMPEDED	STAMPEDE
STAN	STAN
STANDS	STAND
STANDARDISED	STANDARDISE
STANDARDIZED	STANDARDIZE
STANHOPE	STANHOPE
STAPLED	STAPLE
STARS	STAR
STARCHED	STARCH
STARES	STARE
STARKEST	STARKE
STARTS	START
STARTLES	STARTLE
STARVES	STARVE
STASHED	STASH
STATS	STAT
STATES	STATE
STATEMENTING	STATEMENT
STATIONED	STATION
STATO	STATO
STATUS	STATUS
STAUNCHED	STAUNCH
STAVES	STAVE
STAYS	STAY
STE	STE
STEADIES	STEADY
STEALS	STEAL
STEAMS	STEAM
STEAMROLLERED	STEAMROLLER
STEELED	STEEL
STEEPED	STEEP
STEEPENS	STEEPEN
STEEPLING	STEEPLE
STEEPLECHASING	STEEPLECHASE
STEERS	STEER
STELLA	STELLA
STEMS	STEM
STENCILLED	STENCIL
STENTED	STENT
STEPS	STEP
STEREOTYPED	STEREOTYP
STEREOTYPE	STEREOTYPE
STERILISED	STERILISE
STERILIZED	STERILIZE
STERNEST	STERNE
STEWED	STEW
STEWARDING	STEWARD
STI	STI
STICKS	STICK
STICKIEST	STICKY
STIFFEST	STIFF
STIFFENS	STIFFEN
STIFLES	STIFLE
STIGMATISED	STIGMATISE
STIGMATIZES	STIGMATIZE
STILLED	STILL
STILTED	STILT
STIMULATES	STIMULATE
STINGS	STING
STINKS	STINK
STINTED	STINT
STIPPLED	STIPPLE
STIPULATES	STIPULATE
STIRS	STIR
STITCHES	STITCH
STO	STO
STOB	STOB
STOCKS	STOCK
STOCKHOLDERS	STOCKHOLDER
STOCKPILED	STOCKPILE
STOCKIER	STOCKY
STOKES	STOKE
STOMACH	STOMACH
STOMPS	STOMP
STONING	STON
STONED	STONE
STONEWALLED	STONEWAL
STONEWALL	STONEWALL
STONIER	STONY
STOOK	STOOK
STOOPS	STOOP
STOPS	STOP
STOPING	STOPE
STOPPERED	STOPPER
STORES	STORE
STORMS	STORM
STORMIEST	STORMY
STOUTEST	STOUT
STOVED	STOVE
STOWS	STOW
STR	STR
STRA	STRA
STRADA	STRADA
STRADDLES	STRADDLE
STRAFED	STRAFE
STRAGGLES	STRAGGLE
STRAIGHTEST	STRAIGHT
STRAIGHTENS	STRAIGHTEN
STRAINS	STRAIN
STRANDED	STRAND
STRANGEST	STRANGE
STRANGLES	STRANGLE
STRAPPED	STRAP
STRATIFIED	STRATIFY
STRAW	STRAW
STRAYS	STRAY
STREAKS	STREAK
STREAMED	STREAM
STREAMLINES	STREAMLINE
STREGA	STREGA
STRENGTHENS	STRENGTHEN
STRESSES	STRESS
STRETCHES	STRETCH
STRETCHERED	STRETCHER
STREWN	STREW
STREWTH	STREWTH
STRIATED	STRIATE
STRICTEST	STRICT
STRICTURING	STRICTURE
STRIDES	STRIDE
STRIKES	STRIKE
STRINGS	STRING
STRIPS	STRIP
STRIPING	STRIPE
STRIVES	STRIVE
STROKES	STROKE
STROLLED	STROL
STROLLS	STROLL
STRONGEST	STRONG
STRUCTURES	STRUCTURE
STRUGGLES	STRUGGLE
STRUM	STRUM
STRUTS	STRUT
STU	STU
STUBS	STUB
STUBBIER	STUBBY
STUDDED	STUD
STUDIES	STUDY
STUFFS	STUFF
STUFFIEST	STUFFY
STULTIFIED	STULTIFY
STUMBLES	STUMBLE
STUMPED	STUMP
STUNS	STUN
STUNK	STUNK
STUNTED	STUNT
STUPEFIED	STUPEFY
STUPIDEST	STUPIDE
STURDIEST	STURDY
STURM	STURM
STUTTERS	STUTTER
STYLES	STYLE
STYLISED	STYLISE
STYMIED	STYMY
SU	SU
SUBBED	SUB
SUBCLONED	SUBCLON
SUBCONTRACTED	SUBCONTRACT
SUBCULTURES	SUBCULTURE
SUBDIVIDES	SUBDIVIDE
SUBDUCTED	SUBDUCT
SUBDUES	SUBDUE
SUBJECTS	SUBJECT
SUBJUGATED	SUBJUGATE
SUBLETTING	SUBLET
SUBLIMATE	SUBLIMATE
SUBMERGED	SUBMERGE
SUBMITS	SUBMIT
SUBORDINATED	SUBORDINATE
SUBORNED	SUBORN
SUBPOENAED	SUBPOENA
SUBSCRIBES	SUBSCRIBE
SUBSERVED	SUBSERVE
SUBSIDES	SUBSIDE
SUBSIDISES	SUBSIDISE
SUBSIDIZES	SUBSIDIZE
SUBSISTS	SUBSIST
SUBSTANCE	SUBSTANCE
SUBSTANTIATES	SUBSTANTIATE
SUBSTITUTES	SUBSTITUTE
SUBSUMES	SUBSUME
SUBTEST	SUBT
SUBTENDS	SUBTEND
SUBTITLED	SUBTITLE
SUBTLEST	SUBTL
SUBTRACTS	SUBTRACT
SUBTYPES	SUBTYPE
SUBUNITS	SUBUNIT
SUBVERTS	SUBVERT
SUC	SUC
SUCCEEDS	SUCCEED
SUCCOUR	SUCCOUR
SUCCUMBS	SUCCUMB
SUCCUSSED	SUCCUSS
SUCH	SUCH
SUCKS	SUCK
SUCKERED	SUCKER
SUCKLES	SUCKLE
SUCRALFATE	SUCRALFATE
SUES	SUE
SUEY	SUEY
SUFFERS	SUFFER
SUFFICES	SUFFICE
SUFFIXED	SUFFIX
SUFFOCATES	SUFFOCATE
SUFFUSES	SUFFUSE
SUGAR	SUGAR
SUGARED	SUGARE
SUGGESTS	SUGGEST
SUI	SUI
SUIS	SUIS
SUISSE	SUISSE
SUITS	SUIT
SUITE	SUITE
SUJET	SUJET
SUKENICK	SUKENICK
SULKS	SULK
SULLIED	SULLY
SUMS	SUM
SUMMA	SUMMA
SUMMARISES	SUMMARISE
SUMMARIZES	SUMMARIZE
SUMMAT	SUMMAT
SUMMER	SUMMER
SUMMERCHILD	SUMMERCHILD
SUMMONS	SUMMON
SUMMOND	SUMMOND
SUMMONS	SUMMONS
SUMMONSED	SUMMONSE
SUNNING	SUN
SUNBED	SUNB
SUNBATHE	SUNBATHE
SUNBATHING	SUNBTHE
SUNCONNECT	SUNCONNECT
SUNDERED	SUNDER
SUNIL	SUNIL
SUNLOUNGERS	SUNLOUNGER
SUNNIEST	SUNNY
SUNTANNED	SUNTAN
SUPS	SUP
SUPERCOILING	SUPERCOIL
SUPERCOMPUTING	SUPERCOMPUTE
SUPERCOOLING	SUPERCOOL
SUPERIMPOSES	SUPERIMPOSE
SUPERINTEND	SUPERINTEND
SUPERPOSED	SUPERPOSE
SUPERSEDES	SUPERSEDE
SUPERVENED	SUPERVEN
SUPERVENES	SUPERVENE
SUPERVISES	SUPERVISE
SUPP	SUPP
SUPPLANTS	SUPPLANT
SUPPLING	SUPPLE
SUPPLEMENTS	SUPPLEMENT
SUPPLIES	SUPPLY
SUPPO	SUPPO
SUPPORTS	SUPPORT
SUPPOSES	SUPPOSE
SUPPOSING	SUPPOSING
SUPPRESSES	SUPPRESS
SUPPURATING	SUPPURATE
SUPRISED	SUPRISE
SUR	SUR
SURCHARGED	SURCHARGE
SUREST	SURE
SURFED	SURF
SURFACED	SURFACE
SURFEITED	SURFEIT
SURGES	SURGE
SURMISES	SURMISE
SURMOUNTS	SURMOUNT
SURPASSES	SURPASS
SURPRISES	SURPRISE
SURRENDERS	SURRENDER
SURROUNDS	SURROUND
SURVEYS	SURVEY
SURVIVES	SURVIVE
SUS	SUS
SUSPECTS	SUSPECT
SUSPENDS	SUSPEND
SUSSED	SUSS
SUSTAINS	SUSTAIN
SUTURING	SUTURE
SUZANNAH	SUZANNAH
SW	SW
SWA	SWA
SWABBED	SWAB
SWADDLED	SWADDLE
SWAGGED	SWAG
SWAGGERING	SWAGGER
SWALLOWS	SWALLOW
SWAMPS	SWAMP
SWANNING	SWAN
SWANKING	SWANK
SWAPS	SWAP
SWARMS	SWARM
SWASHBUCKLING	SWASHBUCKLE
SWATTED	SWAT
SWATHED	SWATHE
SWAYS	SWAY
SWE	SWE
SWEARS	SWEAR
SWEATS	SWEAT
SWEEPS	SWEEP
SWEETEST	SWEET
SWEETENS	SWEETEN
SWEETEX	SWEETEX
SWELLS	SWELL
SWELTERING	SWELTER
SWERVES	SWERVE
SWI	SWI
SWIFTEST	SWIFT
SWIFTAIR	SWIFTAIR
SWIG	SWIG
SWILLS	SWILL
SWIMS	SWIM
SWINDLED	SWINDLE
SWINGS	SWING
SWIPES	SWIPE
SWIRLS	SWIRL
SWISHES	SWISH
SWITCHES	SWITCH
SWIVELS	SWIVEL
SWOONED	SWOON
SWOOPS	SWOOP
SWOOSHING	SWOOSH
SWOPS	SWOP
SWOT	SWOT
SY	SY
SYD	SYD
SYLLABUB	SYLLABUB
SYLPHIDE	SYLPHIDE
SYLPHIDES	SYLPHIDES
SYMBOLISES	SYMBOLISE
SYMBOLIZES	SYMBOLIZE
SYMPATHISES	SYMPATHISE
SYMPATHIZES	SYMPATHIZE
SYMPHONIE	SYMPHONIE
SYNAPSES	SYNAPSE
SYNCHRONISES	SYNCHRONISE
SYNCHRONIZED	SYNCHRONIZE
SYNDICATED	SYNDICATE
SYNTHESISES	SYNTHESISE
SYNTHESIZES	SYNTHESIZE
SYPHONED	SYPHON
SYRINGES	SYRINGE
SYS	SYS
SYSTEMATISED	SYSTEMATISE
SYSTEMATIZED	SYSTEMATIZE
T	T
TA	TA
TABBED	TAB
TABLED	TABLE
TABULA	TABULA
TABULATES	TABULATE
TACITURN	TACITURN
TACKED	TACK
TACKLES	TACKLE
TAE	TAE
TAGS	TAG
TAI	TAI
TAIGH	TAIGH
TAILS	TAIL
TAILLE	TAILLE
TAILORS	TAILOR
TAILORING	TAILORE
TAINTS	TAINT
TAK	TAK
TAKES	TAKE
TAKEOVER	TAKEOVER
TAKETH	TAKETH
TAL	TAL
TALCOTT	TALCOTT
TALKS	TALK
TALKIN	TALKIN
TALLEST	TALL
TALLIES	TALLY
TAMBURLAINE	TAMBURLAINE
TAMES	TAME
TAMMUZ	TAMMUZ
TAMP	TAMP
TAMPERS	TAMPER
TANS	TAN
TANGLES	TANGLE
TANGO	TANGO
TANK	TANK
TANT	TANT
TANTALISED	TANTALISE
TANTALIZE	TANTALIZE
TAPS	TAP
TAPES	TAPE
TAPERED	TAPER
TAQ	TAQ
TARRED	TAR
TARA	TARA
TARGETS	TARGET
TARNISHED	TARNISH
TARRAH	TARRAH
TARRIED	TARRY
TARTED	TART
TASKED	TASK
TASSELLED	TASSEL
TASTES	TASTE
TASTIEST	TASTY
TATTOOING	TATTOO
TATTOOED	TATTOOE
TAU	TAU
TAUNTS	TAUNT
TAUTER	TAUT
TAUTEN	TAUTEN
TAXES	TAX
TAXI	TAXI
TAXIED	TAXY
TE	TE
TEA	TEA
TEACHES	TEACH
TEAMS	TEAM
TEARS	TEAR
TEASES	TEASE
TECH	TECH
TECHNIQUE	TECHNIQUE
TEES	TEE
TEED	TEED
TEEMS	TEEM
TEENIEST	TEENY
TEETERS	TEETER
TEK	TEK
TEL	TEL
TELE	TELE
TELEGRAPHED	TELEGRAPH
TELEKOM	TELEKOM
TELEMARKETING	TELEMARKETE
TELEPHONES	TELEPHONE
TELEPORT	TELEPORT
TELESCOPED	TELESCOPE
TELEVISED	TELEVISE
TELEWORKING	TELEWORK
TELEXED	TELEX
TELLS	TELL
TEM	TEM
TEMPING	TEMP
TEMPERS	TEMPER
TEMPLE	TEMPLE
TEMPO	TEMPO
TEMPORISED	TEMPORISE
TEMPS	TEMPS
TEMPTS	TEMPT
TEN	TEN
TENANTED	TENANT
TENDS	TEND
TENDERS	TENDER
TENDEREST	TENDERE
TENGIZ	TENGIZ
TENS	TENS
TENSES	TENSE
TENSIONED	TENSION
TENTH	TENTH
TENTHS	TENTHS
TENURED	TENURE
TER	TER
TERMS	TERM
TERMINATES	TERMINATE
TERMINUS	TERMINUS
TERRA	TERRA
TERRE	TERRE
TERRI	TERRI
TERRIBLE	TERRIBLE
TERRIFIES	TERRIFY
TERRORISES	TERRORISE
TERRORIZES	TERRORIZE
TES	TES
TESFAYE	TESFAYE
TESS	TESS
TESTS	TEST
TESTA	TESTA
TESTIFIES	TESTIFY
TETHERS	TETHER
TH	TH
THA	THA
THAN	THAN
THANKS	THANK
THAT	THAT
THATCH	THATCH
THAWS	THAW
THE	THE
THEATER	THEATER
THEATRE	THEATRE
THEIRS	THEIRS
THEIRSELF	THEIRSELF
THEMATIZE	THEMATIZE
THEMED	THEME
THEMSELF	THEMSELF
THEMSELVES	THEMSELVES
THEN	THEN
THEORISED	THEORISE
THEORIZED	THEORIZE
THER	THER
THERE	THERE
THERESE	THERESE
THES	THES
THESE	THESE
THEY	THEY
THI	THI
THICKEST	THICK
THICKENS	THICKEN
THIEVED	THIEVE
THINS	THIN
THINE	THINE
THINKS	THINK
THIR	THIR
THIRD	THIRD
THIRDS	THIRDS
THIRSTING	THIRST
THIRSTIER	THIRSTY
THIRTEEN	THIRTEEN
THIRTEENTH	THIRTEENTH
THIRTIES	THIRTIES
THIRTIETH	THIRTIETH
THIRTY	THIRTY
THIRTYSOMETHING	THIRTYSOMTHE
THIS	THIS
THO	THO
THOMS	THOM
THORNIEST	THORNY
THOROLD	THOROLD
THOSE	THOSE
THOU	THOU
THOUGH	THOUGH
THOUSAND	THOUSAND
THOUSANDS	THOUSANDS
THOUSANDTH	THOUSANDTH
THOUSANDTHS	THOUSANDTHS
THR	THR
THRASHES	THRASH
THRE	THRE
THREADS	THREAD
THREATENS	THREATEN
THREE	THREE
THREES	THREES
THRESHES	THRESH
THRILLED	THRIL
THRILLS	THRILL
THRIVES	THRIVE
THROBS	THROB
THRONGED	THRONG
THROTTLED	THROTTLE
THROUGH	THROUGH
THROUGHOUT	THROUGHOUT
THROWS	THROW
THRU	THRU
THRUMMING	THRUM
THRUSTS	THRUST
THS	THS
THU	THU
THUD	THUD
THUMBS	THUMB
THUMPS	THUMP
THUNDERS	THUNDER
THUNK	THUNK
THUR	THUR
THURINGIENSIS	THURINGIENSIS
THWARTS	THWART
THYSELF	THYSELF
TI	TI
TIBI	TIBI
TICKS	TICK
TICKETING	TICKETE
TICKLES	TICKLE
TIDIES	TIDY
TIES	TIE
TIEMPO	TIEMPO
TIERRA	TIERRA
TIGHTEST	TIGHT
TIGHTENS	TIGHTEN
TIL	TIL
TILED	TILE
TILLED	TILL
TILTS	TILT
TIMBERED	TIMBER
TIMES	TIME
TIMES	TIMES
TIMETABLED	TIMETABLE
TINNING	TIN
TINGED	TINGE
TINGLE	TINGLE
TINKS	TINK
TINKERS	TINKER
TINKLE	TINKLE
TINTS	TINT
TINIEST	TINY
TIPS	TIP
TIPPLING	TIPPLE
TIPTOED	TIPTOE
TIRES	TIRE
TITILLATES	TITILLATE
TITLED	TITLE
TITO	TITO
TITRATED	TITRATE
TITRE	TITRE
TITTER	TITTER
TOING	TO
TOADS	TOAD
TOADYING	TOADY
TOASTS	TOAST
TOBOGGANING	TOBOGGANE
TOD	TOD
TODDLE	TODDLE
TOE	TOE
TOGGED	TOG
TOGETHERS	TOGETHER
TOGGLE	TOGGLE
TOI	TOI
TOILS	TOIL
TOILET	TOILET
TOILETTE	TOILETTE
TOL	TOL
TOLERATES	TOLERATE
TOLLS	TOLL
TOM	TOM
TONING	TON
TONES	TONE
TONGING	TONG
TONGUING	TONGUE
TONI	TONI
TONSURED	TONSURE
TOO	TOO
TOOLED	TOOL
TOOLKIT	TOOLKIT
TOOT	TOOT
TOOTLING	TOOTLE
TOPS	TOP
TOPLOG	TOPLOG
TOPPLES	TOPPLE
TOPSY	TOPSY
TOR	TOR
TORBAY	TORBAY
TORCHED	TORCH
TORMENTS	TORMENT
TORPEDO	TORPEDO
TORPEDOED	TORPEDOE
TORRENTE	TORRENTE
TORSADES	TORSADE
TORT	TORT
TORTURES	TORTURE
TOSSES	TOSS
TOTTED	TOT
TOTALS	TOTAL
TOTALIZED	TOTALIZE
TOTING	TOTE
TOTO	TOTO
TOTTERS	TOTTER
TOUCHES	TOUCH
TOUCHING	TOUCHING
TOUGHEST	TOUGH
TOUGHENS	TOUGHEN
TOURS	TOUR
TOUS	TOUS
TOUSLED	TOUSLE
TOUTED	TOUT
TOWS	TOW
TOWARD	TOWARD
TOWARDS	TOWARDS
TOWEL	TOWEL
TOWERS	TOWER
TOXTETH	TOXTETH
TOYS	TOY
TR	TR
TRA	TRA
TRABAJADORES	TRABAJADORES
TRACES	TRACE
TRACKS	TRACK
TRACKBED	TRACKB
TRACTATUS	TRACTATUS
TRAD	TRAD
TRADES	TRADE
TRADITION	TRADITION
TRADUCED	TRADUCE
TRAFFIC	TRAFFIC
TRAFFICKED	TRAFFICK
TRAILS	TRAIL
TRAINS	TRAIN
TRAIPSE	TRAIPSE
TRAMMELLED	TRAMMEL
TRAMPED	TRAMP
TRAMPLES	TRAMPLE
TRAMPOLINING	TRAMPOLINE
TRAN	TRAN
TRANCED	TRANCE
TRANS	TRANS
TRANSACTED	TRANSACT
TRANSCENDS	TRANSCEND
TRANSCRIBES	TRANSCRIBE
TRANSDUCED	TRANSDUCE
TRANSFECTED	TRANSFECT
TRANSFERS	TRANSFER
TRANSFIGURED	TRANSFIGURE
TRANSFIXED	TRANSFIX
TRANSFORMS	TRANSFORM
TRANSFUSED	TRANSFUSE
TRANSGRESSES	TRANSGRESS
TRANSIT	TRANSIT
TRANSITIONED	TRANSITION
TRANSLATES	TRANSLATE
TRANSLOCATED	TRANSLOCATE
TRANSMITS	TRANSMIT
TRANSMOGRIFIED	TRANSMOGRIFY
TRANSMUTES	TRANSMUTE
TRANSPIRES	TRANSPIRE
TRANSPLANTS	TRANSPLANT
TRANSPORTS	TRANSPORT
TRANSPOSES	TRANSPOSE
TRAPS	TRAP
TRASHED	TRASH
TRAUMATISED	TRAUMATISE
TRAUMATIZED	TRAUMATIZE
TRAVAIL	TRAVAIL
TRAVELS	TRAVEL
TRAVERSES	TRAVERSE
TRAVIATA	TRAVIATA
TRAWLED	TRAWL
TRE	TRE
TREADS	TREAD
TREASURES	TREASURE
TREATS	TREAT
TREBLES	TREBLE
TREKS	TREK
TRELOAR	TRELOAR
TREMBLES	TREMBLE
TRENCHING	TRENCH
TRENDING	TREND
TRENDIEST	TRENDY
TRES	TRES
TR�S	TR�S
TRESPASSES	TRESPASS
TRI	TRI
TRIALLED	TRIAL
TRICEPS	TRICEP
TRICKS	TRICK
TRICKLES	TRICKLE
TRICKIEST	TRICKY
TRIFLED	TRIFLE
TRIGGERS	TRIGGER
TRILLS	TRILL
TRILLION	TRILLION
TRILLIONS	TRILLIONS
TRIMMED	TRIM
TRIOMPHE	TRIOMPHE
TRIPS	TRIP
TRIPLES	TRIPLE
TRISTAN	TRISTAN
TRIUMPHS	TRIUMPH
TRIVIALISES	TRIVIALISE
TRIVIALIZES	TRIVIALIZE
TROIS	TROIS
TROLLING	TROLL
TROLLOPE	TROLLOPE
TROOPED	TROOP
TROP	TROP
TROTS	TROT
TROUBLES	TROUBLE
TROUBLESHOOT	TROUBLESHOOT
TROUNCED	TROUNCE
TROVATORE	TROVATORE
TROW	TROW
TRU	TRU
TRUANTING	TRUANT
TRUCKED	TRUCK
TRUDGED	TRUDGE
TRUE	TRUE
TRUMPS	TRUMP
TRUMPETS	TRUMPET
TRUMPETED	TRUMPETE
TRUNCATED	TRUNCATE
TRUNDLES	TRUNDLE
TRUNKING	TRUNK
TRUONG	TRUONG
TRUSSED	TRUSS
TRUSTS	TRUST
TRIES	TRY
TS	TS
TSAI	TSAI
TT	TT
TU	TU
TUBBING	TUB
TUBED	TUBE
TUCKS	TUCK
TUE	TUE
TUES	TUES
TUFTING	TUFT
TUGS	TUG
TUMBLES	TUMBLE
TUN	TUN
TUNES	TUNE
TUNG	TUNG
TUNNELLED	TUNNEL
TUPAC	TUPAC
TUR	TUR
TURBOCHARGING	TURBOCHARGE
TURFED	TURF
TURNS	TURN
TURNIPS	TURNIP
TURPI	TURPI
TUSSLE	TUSSLE
TUTS	TUT
TUTOR	TUTOR
TUTORED	TUTORE
TUTTE	TUTTE
TUTTI	TUTTI
TW	TW
TWANGED	TWANG
TWE	TWE
TWEAKED	TWEAK
TWELFTH	TWELFTH
TWELFTHS	TWELFTHS
TWELVE	TWELVE
TWELVES	TWELVES
TWEN	TWEN
TWENTIES	TWENTIES
TWENTIETH	TWENTIETH
TWENTY	TWENTY
TWIDDLES	TWIDDLE
TWIGGED	TWIG
TWINS	TWIN
TWINED	TWINE
TWINGE	TWINGE
TWINKLES	TWINKLE
TWIRLS	TWIRL
TWISTS	TWIST
TWITTED	TWIT
TWITCHES	TWITCH
TWITTERS	TWITTER
TWO	TWO
TWOS	TWOS
TY	TY
TYNDALL	TYNDALL
TYPES	TYPE
TYPECAST	TYPECAST
TYPESET	TYPESET
TYPIFIES	TYPIFY
TZU	TZU
T?S	T?S
U	U
UDF	UDF
UEZD	UEZD
UF	UF
UFF	UFF
UGH	UGH
UGLIEST	UGLY
UH	UH
ULRICH	ULRICH
ULTRA	ULTRA
UMMED	UM
UMM	UMM
UMPIRED	UMPIRE
UMPTEEN	UMPTEEN
UMPTEENTH	UMPTEENTH
UN	UN
UNA	UNA
UNAFRAID	UNAFRAY
UNAPPEALING	UNAPPEAL
UNAPPETISING	UNAPPETISE
UNAPPETIZING	UNAPPETIZE
UNBALANCES	UNBALANCE
UNBELIEVERS	UNBELIEVER
UNBEND	UNBEND
UNBOUND	UNBIND
UNBLINKING	UNBLINK
UNBLOCK	UNBLOCK
UNBUCKLE	UNBUCKLE
UNBUNDLE	UNBUNDLE
UNBURDENED	UNBURDEN
UNBUTTONED	UNBUTTON
UNCLENCH	UNCLENCH
UNCLIP	UNCLIP
UNCOIL	UNCOIL
UNCOMPLAINING	UNCOMPLAIN
UNCORKED	UNCORK
UNCOUPLE	UNCOUPLE
UNCOVERS	UNCOVER
UNCURL	UNCURL
UND	UND
UNDER	UNDER
UNDERACHIEVING	UNDERACHIEVE
UNDERBID	UNDERBID
UNDERCUTS	UNDERCUT
UNDERESTIMATES	UNDERESTIMATE
UNDERGOES	UNDERGO
UNDERGROUNDING	UNDERGROUND
UNDERLAIN	UNDERLAIN
UNDERLAID	UNDERLAY
UNDERLET	UNDERLET
UNDERLIE	UNDERLIE
UNDERLINES	UNDERLINE
UNDERLIES	UNDERLY
UNDERMINES	UNDERMINE
UNDERNEATH	UNDERNEATH
UNDERPARTS	UNDERPART
UNDERPAID	UNDERPAY
UNDERPINS	UNDERPIN
UNDERPLAYS	UNDERPLAY
UNDERPRICING	UNDERPRICE
UNDERRATES	UNDERRATE
UNDERSCORES	UNDERSCORE
UNDERSHOOT	UNDERSHOOT
UNDERSPENDING	UNDERSPEND
UNDERSTAFFING	UNDERSTAFF
UNDERSTANDS	UNDERSTAND
UNDERSTATES	UNDERSTATE
UNDERSTEERS	UNDERSTEER
UNDERSTUDY	UNDERSTUDY
UNDERTAKES	UNDERTAKE
UNDERTONES	UNDERTONE
UNDERVALUES	UNDERVALUE
UNDERWRITING	UNDERWRIT
UNDERWRITES	UNDERWRITE
UNDERWRITTEN	UNDERWRITTEN
UNDERWROTE	UNDERWROTE
UNDESERVING	UNDESERVE
UNDONE	UNDO
UNDOES	UNDOE
UNDRESSES	UNDRESS
UNDULATE	UNDULATE
UNE	UNE
UNEARTHS	UNEARTH
UNEM	UNEM
UNEP	UNEP
UNFASTENED	UNFASTEN
UNFETTERED	UNFETTER
UNFIT	UNFIT
UNFOLDS	UNFOLD
UNFREEZE	UNFREEZE
UNFURLS	UNFURL
UNG	UNG
UNGER	UNGER
UNHAPPIEST	UNHAPPY
UNHINGED	UNHINGE
UNHITCHED	UNHITCH
UNHOOKED	UNHOOK
UNI	UNI
UNIFIES	UNIFY
UNION	UNION
UNISEX	UNISEX
UNISOFT	UNISOFT
UNITES	UNITE
UNIVEL	UNIVEL
UNIVERSALISED	UNIVERSALISE
UNIVERSITE	UNIVERSITE
UNKINDEST	UNKIND
UNKNOTTING	UNKNOT
UNLACED	UNLACE
UNLEARN	UNLEARN
UNLEASHES	UNLEASH
UNLESS	UNLESS
UNLIKE	UNLIKE
UNLIKELIEST	UNLIKELY
UNLOADS	UNLOAD
UNLOCKS	UNLOCK
UNLUCKIEST	UNLUCKY
UNMADE	UNMADE
UNMAKE	UNMAKE
UNMASKS	UNMASK
UNNERVES	UNNERVE
UNPACKS	UNPACK
UNPICKED	UNPICK
UNPLUG	UNPLUG
UNPROVEN	UNPROVEN
UNQUOTE	UNQUOTE
UNRAVELS	UNRAVEL
UNRESISTING	UNRESIST
UNROLLED	UNROL
UNROLLS	UNROLL
UNS	UNS
UNSADDLE	UNSADDLE
UNSATISFYING	UNSATISFY
UNSAID	UNSAY
UNSCRAMBLE	UNSCRAMBLE
UNSCREWS	UNSCREW
UNSEALED	UNSEAL
UNSEATED	UNSEAT
UNSETTLES	UNSETTLE
UNSLUNG	UNSLUNG
UNSPARING	UNSPARE
UNSPORTING	UNSPORT
UNSTALL	UNSTALL
UNSTINTING	UNSTINT
UNSURPRISING	UNSURPRISE
UNTANGLES	UNTANGLE
UNTER	UNTER
UNTHREATENING	UNTHREATEN
UNTIE	UNTIE
UNTIL	UNTIL
UNTO	UNTO
UNTIED	UNTY
UNVEILS	UNVEIL
UNWELCOMING	UNWELCOME
UNWINDS	UNWIND
UNWOUND	UNWOUND
UNWRAPS	UNWRAP
UNZIPS	UNZIP
UPPED	UP
UPBRAIDS	UPBRAID
UPDATES	UPDATE
UPENDED	UPEND
UPGRADES	UPGRADE
UPHAUL	UPHAUL
UPHELD	UPHELD
UPHOLDS	UPHOLD
UPHOLSTERED	UPHOLSTER
UPLIFTED	UPLIFT
UPLOADING	UPLOAD
UPON	UPON
UPRATED	UPRATE
UPRIGHTED	UPRIGHT
UPROOTED	UPROOT
UPSETS	UPSET
UPSTAGED	UPSTAGE
UPWELLING	UPWEL
UPWIND	UPWIND
UR	UR
URGES	URGE
URGH	URGH
URIAH	URIAH
URINATES	URINATE
US	US
USAAF	USAAF
USAF	USAF
USES	USE
USHERS	USHER
USURPS	USURP
UTILISES	UTILISE
UTILIZES	UTILIZE
UTTERS	UTTER
UVB	UVB
UZBEK	UZBEK
V	V
VA	VA
VACATES	VACATE
VACATIONING	VACATION
VACCINATED	VACCINATE
VACILLATES	VACILLATE
VACUUM	VACUUM
VACUUMED	VACUUME
VAGUEST	VAGU
VAINEST	VAIN
VALETING	VALETE
VALIDATES	VALIDATE
VALOR	VALOR
VALOREM	VALOREM
VALOUR	VALOUR
VALUES	VALUE
VAMP	VAMP
VAN	VAN
VANDALISED	VANDALISE
VANDALIZED	VANDALIZE
VANISHES	VANISH
VANQUISHED	VANQUISH
VAPORISES	VAPORISE
VAPORIZE	VAPORIZE
VAR	VAR
VARIEGATA	VARIEGATA
VARIEGATED	VARIEGATE
VARNISHED	VARNISH
VARIES	VARY
VASE	VASE
VASTEST	VAST
VAUDE	VAUDE
VAUDEVILLE	VAUDEVILLE
VAULTS	VAULT
VAUNTED	VAUNT
VE	VE
VEERS	VEER
VEGETATE	VEGETATE
VEILS	VEIL
VENDING	VEND
VENEERED	VENEER
VENERATED	VENERATE
VENTS	VENT
VENTILATED	VENTILATE
VENTURES	VENTURE
VERS	VER
VERANDAH	VERANDAH
VERBALISE	VERBALISE
VERBIVORE	VERBIVORE
VERBUM	VERBUM
VERDUN	VERDUN
VERGES	VERGE
VERIFIES	VERIFY
VERITAS	VERITAS
VERKEHRSBERUHIGUNG	VERKEHRSBERUHIGUNG
VERN	VERN
VERONICA	VERONICA
VERRE	VERRE
VERS	VERS
VERSA	VERSA
VERSED	VERSE
VERSIFY	VERSIFY
VERSIONED	VERSION
VERSUS	VERSUS
VERTS	VERT
VERUM	VERUM
VERY	VERY
VESTED	VEST
VETS	VET
VETOED	VETO
VETOES	VETOE
VEXES	VEX
VI	VI
VIA	VIA
VIBING	VIBE
VIBRAM	VIBRAM
VIBRATES	VIBRATE
VIBURNUM	VIBURNUM
VIC	VIC
VICE	VICE
VICTIMISED	VICTIMISE
VICTIMIZED	VICTIMIZE
VICTUALLED	VICTUAL
VID	VID
VIDE	VIDE
VIDEO	VIDEO
VIDEOCART	VIDEOCART
VIDEOED	VIDEOE
VIDEOTAPED	VIDEOTAPE
VIES	VIE
VIEUX	VIEUX
VIEWS	VIEW
VII	VII
VIII	VIII
VILEST	VILE
VILIFIED	VILIFY
VILL	VILL
VILLAGE	VILLAGE
VILLE	VILLE
VIN	VIN
VINDICATES	VINDICATE
VINELOTT	VINELOTT
VINO	VINO
VIOLA	VIOLA
VIOLATES	VIOLATE
VIOLE	VIOLE
VIOLON	VIOLON
VIR	VIR
VIRES	VIRE
VIRES	VIRES
VIS	VIS
VISCOUNTESS	VISCOUNTESS
VISITS	VISIT
VISTA	VISTA
VISUALISES	VISUALISE
VISUALIZES	VISUALIZE
VIT	VIT
VITA	VITA
VITE	VITE
VITIATES	VITIATE
VITICULTURE	VITICULTURE
VITIS	VITIS
VITRO	VITRO
VIVA	VIVA
VIVACE	VIVACE
VIVANT	VIVANT
VIVES	VIVE
VIVENDI	VIVENDI
VIVO	VIVO
VIVRE	VIVRE
VO	VO
VOCALISE	VOCALISE
VOCE	VOCE
VOICES	VOICE
VOIDS	VOID
VOILA	VOILA
VOIL�	VOIL�
VOIR	VOIR
VOIX	VOIX
VOL	VOL
VOLLEYS	VOLLEY
VOLTE	VOLTE
VOLUNTEERED	VOLUNTEER
VOM	VOM
VOMITS	VOMIT
VON	VON
VOOR	VOOR
VOR	VOR
VORTEXING	VORTEX
VOS	VOS
VOTES	VOTE
VOTRE	VOTRE
VOUCHED	VOUCH
VOUCHSAFES	VOUCHSAFE
VOUS	VOUS
VOWS	VOW
VOX	VOX
VOYAGE	VOYAGE
VOYEUR	VOYEUR
VS	VS
VU	VU
VUE	VUE
W	W
WA	WA
WACK	WACK
WACKIEST	WACKY
WADDED	WAD
WADDLES	WADDLE
WADES	WADE
WAFFLES	WAFFLE
WAFTS	WAFT
WAGS	WAG
WAGES	WAGE
WAGERED	WAGER
WAGGLES	WAGGLE
WAGGONING	WAGGON
WAH	WAH
WAHEY	WAHEY
WAI	WAI
WAILS	WAIL
WAITS	WAIT
WAITRESS	WAITRESS
WAIVES	WAIVE
WAKES	WAKE
WAKENS	WAKEN
WAL	WAL
WALING	WALE
WALKS	WALK
WALLS	WALL
WALLOP	WALLOP
WALLOPED	WALLOPE
WALLOW	WALLOW
WALLPAPERED	WALLPAPER
WALTZ	WALTZ
WALTZES	WALTZE
WANS	WAN
WANDERS	WANDER
WANES	WANE
WANGLED	WANGLE
WANK	WANK
WANN	WANN
WANTS	WANT
WAQAR	WAQAR
WARS	WAR
WARBLES	WARBLE
WARDED	WARD
WARMS	WARM
WARNS	WARN
WARPS	WARP
WARRANTS	WARRANT
WARIER	WARY
WAS	WAS
WASHES	WASH
WASIM	WASIM
WASS	WASS
WASSAILING	WASSAIL
WAST	WAST
WASTES	WASTE
WAT	WAT
WATCHES	WATCH
WATERS	WATER
WATERBORNE	WATERBORNE
WATERLOGGING	WATERLOG
WATERPROOFED	WATERPROOF
WATERSKIING	WATERSKI
WATTLING	WATTLE
WAVES	WAVE
WAVERS	WAVER
WAXES	WAX
WAY	WAY
WAYLAID	WAYLAY
WD	WD
WES	WE
WEAKEST	WEAK
WEAKENS	WEAKEN
WEALTHIEST	WEALTHY
WEANS	WEAN
WEARS	WEAR
WEARIED	WEARY
WEATHERS	WEATHER
WEATHERBEATEN	WEATHERBEATEN
WEATHERPROOFS	WEATHERPROOF
WEAVES	WEAVE
WEDS	WED
WEDGES	WEDGE
WEED	WEE
WEEDS	WEED
WEEKENDING	WEEKEND
WEEPS	WEEP
WEIGHS	WEIGH
WEIGHTS	WEIGHT
WEIGHTIEST	WEIGHTY
WEIRDEST	WEIRDE
WEL	WEL
WELCH	WELCH
WELCOMES	WELCOME
WELDS	WELD
WELFARE	WELFARE
WELLS	WELL
WELSHING	WELSH
WELT	WELT
WELTER	WELTER
WEN	WEN
WENDS	WEND
WER	WER
WERDER	WERDER
WERE	WERE
WERT	WERT
WES	WES
WEST	WEST
WESTMOUNT	WESTMOUNT
WETS	WET
WETHER	WETHER
WH	WH
WHA	WHA
WHACKS	WHACK
WHALING	WHALE
WHAM	WHAM
WHAT	WHAT
WHATEVER	WHATEVER
WHATSOEVER	WHATSOEVER
WHE	WHE
WHEE	WHEE
WHEEDLES	WHEEDLE
WHEELS	WHEEL
WHEEZES	WHEEZE
WHELPED	WHELP
WHEN	WHEN
WHENCE	WHENCE
WHENEVER	WHENEVER
WHERE	WHERE
WHEREABOUTS	WHEREABOUTS
WHEREAS	WHEREAS
WHEREAT	WHEREAT
WHEREBY	WHEREBY
WHEREFORE	WHEREFORE
WHEREIN	WHEREIN
WHEREOF	WHEREOF
WHERESOEVER	WHERESOEVER
WHEREUPON	WHEREUPON
WHEREVER	WHEREVER
WHETS	WHET
WHETHER	WHETHER
WHEW	WHEW
WHI	WHI
WHICH	WHICH
WHICHEVER	WHICHEVER
WHICKERED	WHICKER
WHILES	WHILE
WHILST	WHILST
WHIMPERS	WHIMPER
WHINES	WHINE
WHINGE	WHINGE
WHINNYING	WHINNY
WHIPS	WHIP
WHIPLASHED	WHIPLASH
WHIRRING	WHIR
WHIRLS	WHIRL
WHIRLPOOLED	WHIRLPOOL
WHIRR	WHIRR
WHISKS	WHISK
WHISPERS	WHISPER
WHISTLES	WHISTLE
WHIT	WHIT
WHITEST	WHITE
WHITENED	WHITEN
WHITEWASHED	WHITEWASH
WHITHER	WHITHER
WHITTLES	WHITTLE
WHIZ	WHIZ
WHIZZED	WHIZZ
WHO	WHO
WHOA	WHOA
WHOEVER	WHOEVER
WHOLESALING	WHOLESALE
WHOM	WHOM
WHOMEVER	WHOMEVER
WHOO	WHOO
WHOOPING	WHOOP
WHOOPEE	WHOOPEE
WHOOPS	WHOOPS
WHOOSHING	WHOOSH
WHORED	WHORE
WHOSE	WHOSE
WHOSOEVER	WHOSOEVER
WHY	WHY
WI	WI
WICKSTED	WICKST
WID	WID
WIDEST	WIDE
WIDENS	WIDEN
WIDOWED	WIDOW
WIE	WIE
WIELDS	WIELD
WIENER	WIENER
WIGGLES	WIGGLE
WIL	WIL
WILBERFORCE	WILBERFORCE
WILDING	WILD
WILING	WILE
WILLS	WILL
WILLE	WILLE
WILLEM	WILLEM
WILTS	WILT
WIM	WIM
WINS	WIN
WINCES	WINCE
WINCHED	WINCH
WINDS	WIND
WINDPROOF	WINDPROOF
WINDSURF	WINDSURF
WINDSURFERS	WINDSURFER
WINED	WINE
WINFAX	WINFAX
WINGS	WING
WINGED	WINGE
WINGROVE	WINGROVE
WINKS	WINK
WINKLED	WINKLE
WINNOWED	WINNOW
WINTERS	WINTER
WIPES	WIPE
WIR	WIR
WIRES	WIRE
WISED	WISE
WISECRACKED	WISECRACK
WISHES	WISH
WISPING	WISP
WIT	WIT
WITH	WITH
WITHDRAWS	WITHDRAW
WITHERS	WITHER
WITHHOLDS	WITHHOLD
WITHIN	WITHIN
WITHOUT	WITHOUT
WITHSTANDS	WITHSTAND
WITHSTANDING	WITHSTANDING
WITNESSETH	WITNESS
WITTERING	WITTER
WITTIEST	WITTY
WIZENED	WIZEN
WLR	WLR
WO	WO
WOBBLES	WOBBLE
WOH	WOH
WOLFED	WOLF
WOM	WOM
WOMANISING	WOMANISE
WOMENS	WOMEN
WON	WON
WONDERS	WONDER
WONG	WONG
WOOS	WOO
WOODTURNING	WOODTURN
WOOF	WOOF
WOOLF	WOOLF
WOOLLIER	WOOLLY
WOR	WOR
WORDS	WORD
WORDPROCESS	WORDPROCESS
WORKS	WORK
WORMED	WORM
WORRIES	WORRY
WORSENS	WORSEN
WORSHIPS	WORSHIP
WORSTED	WORST
WORTH	WORTH
WORTHIEST	WORTHY
WOT	WOT
WOU	WOU
WOUL	WOUL
WOULD	WOULD
WOULDST	WOULDST
WOUNDS	WOUND
WOWED	WOW
WOWEE	WOWEE
WR	WR
WRACKED	WRACK
WRANGLE	WRANGLE
WRAPS	WRAP
WREAKS	WREAK
WREATHES	WREATHE
WRECKS	WRECK
WRENCHES	WRENCH
WRESTED	WREST
WRESTLES	WRESTLE
WRI	WRI
WRIGGLES	WRIGGLE
WRINGS	WRING
WRINKLES	WRINKLE
WRIT	WRIT
WRITES	WRITE
WRITHES	WRITHE
WRO	WRO
WRONG	WRONG
WRONGED	WRONGE
WRITHING	WRTHE
WS	WS
WURGH	WURGH
WUS	WUS
WUTHERING	WUTHER
WUZ	WUZ
WYETH	WYETH
WYSE	WYSE
X	X
XANTHE	XANTHE
XENOGRAFTS	XENOGRAFT
XII	XII
XIII	XIII
XIV	XIV
XIX	XIX
XL	XL
XLI	XLI
XLII	XLII
XLIV	XLIV
XLV	XLV
XS	XS
XV	XV
XVI	XVI
XVII	XVII
XVIII	XVIII
XX	XX
XXI	XXI
XXII	XXII
XXIII	XXIII
XXIV	XXIV
XXIX	XXIX
XXV	XXV
XXVI	XXVI
XXVII	XXVII
XXVIII	XXVIII
XXX	XXX
XXXI	XXXI
XXXII	XXXII
XXXIV	XXXIV
XXXVII	XXXVII
XY	XY
XYZ	XYZ
Y	Y
YA	YA
YAH	YAH
YAKKING	YAK
YAM	YAM
YANKS	YANK
YAPPING	YAP
YARM	YARM
YASAK	YASAK
YAW	YAW
YAWNS	YAWN
YAY	YAY
YC	YC
YD	YD
YE	YE
YEA	YEA
YEAGER	YEAGER
YEAH	YEAH
YEAR	YEAR
YEARNS	YEARN
YEAST	YEAST
YELLS	YELL
YELLOWED	YELLOW
YELPS	YELP
YEN	YEN
YENISEI	YENISEI
YEP	YEP
YER	YER
YERSELF	YERSELF
YES	YES
YET	YET
YI	YI
YIELDS	YIELD
YIPPEE	YIPPEE
YIR	YIR
YO	YO
YOKED	YOKE
YOLKS	YOLK
YOM	YOM
YOMPING	YOMP
YORKED	YORK
YOU	YOU
YOUNG	YOUNG
YOURE	YOURE
YOURS	YOURS
YOURSELF	YOURSELF
YOURSELVES	YOURSELVES
YOUS	YOUS
YOUSE	YOUSE
YOW	YOW
YOWLS	YOWL
YS	YS
YTS	YT
YTP	YTP
YU	YU
YUCK	YUCK
YUGO	YUGO
YUK	YUK
YUL	YUL
YUM	YUM
YUP	YUP
YUSEF	YUSEF
YUSSUF	YUSSUF
YVES	YVE
Z	Z
ZACH	ZACH
ZACK	ZACK
ZAK	ZAK
ZAM	ZAM
ZAPPED	ZAP
ZAUBERFL�TE	ZAUBERFL�TE
ZBIGNIEW	ZBIGNIEW
ZING	ZE
ZEE	ZEE
ZEIDE	ZEIDE
ZEINAB	ZEINAB
ZEITUNG	ZEITUNG
ZELL	ZELL
ZERO	ZERO
ZEROES	ZEROE
ZEROS	ZEROS
ZIGZAGS	ZIGZAG
ZILOG	ZILOG
ZINGING	ZING
ZIPS	ZIP
ZLORF	ZLORF
ZONED	ZON
ZOOMS	ZOOM
ZU	ZU
ZUE	ZUE
ZUM	ZUM
ZUP	ZUP
ZUR	ZUR
ZX	ZX
ZZ	ZZ
ZZAP	ZZAP
?	?
??	??
?	?
?G	?G
G	G
?	?
?G	?G
?H	?H
?S	?S
?T	?T
?	?
?	?
?	?
T	T
?	?
?	?
?	?
?M	?M
?	?
?	?
?	?
?	?
S	S
?	?
F	F
?	?
?	?
O	O
